bahat ziad harfe mizaneh	باهات زیاد حرف میزنه
dar chart sazmani kagab depaartemaane be naam depaartemaane A vojood dasht	در چارت سازمانی کاگب، دپارتمانی به نام دپارتمان A وجود داشت
shoharjan migoft chandtashoun ham azashoun koli kharide kardeh boudan	شوهرجان میگفت چندتاشون هم ازشون کلی خرید کرده بودن
naam shoma chist fin mirestad oh fin	نام شما چیست؟ فین میرستاد: اوه، فین
dorosteh dorosteh mi donestam	درسته درسته .می دونستم
emkan nadaare mageh momkeneh ba aghl o mantegh jor dar nemiad	امکان نداره؟ مگه ممکنه؟ با عقل و منطق جور در نمیاد.
masuliat che kesani ast booom in adamha	مسئولیت چه کسانی است؟ بوووم! این آدمها
agar harkas betavand az tarigh in vasael vared manzel shoma shood	اگر هرکس بتواند از طریق این وسایل وارد منزل شما شود
khob khanom ha o aghayan	خوب ، خانمها و آقایان
galoy pessar ra mi fesharad	گلوی پسر را می فشارد
in kheili shirine o hasaseh	این خیلی شیرین و حساسه
ghabl az inke parvaaz kony	قبل از اینکه پرواز کنی
vali ma fekr mikonim ke shodani ast	ولی ما فکر میکنیم که شدنی است
haman kargrouh kouchak niaz jedi gerfte nemishod	همان کارگروه کوچک نیز جدی گرفته نمیشد
ziba khanoum mi geh khabeh kojan baghieh	زیبا خانوم می گه خوابه کجان بقیه؟
bodo elias ye khordeh shokolaat behem bedeh	بدو الیاس، یه خورده شکلات بهم بده
hamchenin masraf konandegan nemitavaanand in kar ra khoudeshan anjam dahand	همچنین مصرف کنندگان نمیتوانند این کار را خودشان انجام دهند
lebas hayeh mardoone mi shore o aviz mi koneh ro band hamsham pirahan mardoone	لباسهای مردونه می شوره و اویز می کنه رو بند همشم پیراهن مردونه.
man kheili delvapasi boudmouli charhaye naboudnemitavanestim harfi bezanam	من خیلی دلواپس بودم،ولی چارهای نبود،نمیتوانستم حرفی بزنم
dorosteh khoobi ziad darhamkhab badihaie ham dareh	درسته خوبی زیاد داره،اماخب بدیهایی هم داره
bego ye hafteh darash ro baz gozashteh be rouye mardom	بگو یه هفته، درش رو باز گذاشته به روی مردم.
nemidoonam badehaa gharareh doubareh biad o baray hamishe bemoone yana	نمیدونم بعدها قراره دوباره بیاد و برای همیشه بمونه یانه
raas 10 ta saandevich gereft	راس 10 تا ساندویچ گرفت
ghaza napokhtan ya otagh avaz kardanat	غذا نپختن یا اتاق عوض کردنت؟
mi geh ghorob payiezeh beshinim tou hayat	می گه غروب پاییزه بشینیم تو حباط
mi khum bala tarin neshan eftekhar behet ehda konam	می خوام بالا ترین نشان افتخار بهت اهدا کنم
ye had o hodoodi bezaarim	یه حد و حدودی بذاریم
harkasi ba goushi hooshmand khod mitavand ba kaaylaa motasel gardad dar yek mahdodeh makaani	هرکسی با گوشی هوشمند خود میتواند با کایلا متصل گردد در یک محدوده مکانی
parkeh aalam jodaei dareh bara khodesh	پارکه عالم جدایی داره برا خودش
nashnidi sedaye esfandiar ro	نشنیدی صدای اسفندیار رو؟
are ezdevaj chizi badieh	آره ، ازدواج چیزی بدیه
o be javayezi manand behtarin makaan baray kar dast peyda kardeand	و به جوایزی مانند، بهترین مکان برای کار دست پیدا کردند
fekr mi kony orze in kar dari ha	فکر می کنی عرضه این کار داری، ها؟
sioyek saa'at chehelonoh daghigheh o yazdah sanieh zaman board	۳۱ ساعت، ۴۹ دقیقه و ۱۱ ثانیه زمان برد
ghabool mi konam nemi tonam	.قبول می کنم؟ نمی تونم
dar sal dohezaraosizdah man modir ejraaei yek moasese mohandesi beinolmelali bodam dar saanferaansisko	در سال ۲۰۱۳، من مدیر اجرایی یک موسسه مهندسی بینالمللی بودم در سانفرانسیسکو
ostansaraie tasirgozaari ejtemaai takhir raftaar	استانسرایی، تاثیرگذاری اجتماعی، تغییر رفتار
vali kasi delesh baray iran o irani nasookhte ke bekhaad az inkara bokoneh oonvaght digeh key dozdi koneh	، ولی کسی دلش برای ایران و ایرانى نسوخته كه بخواد از اینكارا بكنه، اونوقت دیگه كى دزدى كنه؟؟
vaase shast nafar ro rad konam	.واسه 60 نفر رو رد کنم
ma tahghighi baray farghe tahsilan madares kasb o kar ferestadim ke dar sazmanhaye motafaavet kar mikardand	ما تحقیقی برای فارغ التحصیلان مدارس کسب و کار فرستادیم که در سازمانهای متفاوت کار میکردند
barkhi koneshgarha chips doost darand amma ghatan poul mikhahand	برخی کنشگرها چیپس دوست دارند اما قطعا پول میخواهند
digaran azam miporsand chera tofang nadarad	دیگران ازم میپرسند چرا تفنگ ندارد؟
agar tavanmandieman baray tahaghogh ta'ahodaat ra si darsad afzaayesh dahim	اگر توانمندیمان برای تحقق تعهدات را سی درصد افزایش دهیم
azmayesh shishe zedgloleh dar sal 1930 milaadi 1309 khorshidi	آزمایش شیشه ضدگلوله در سال ۱۹۳۰ میلادی ۱۳۰۹ خورشیدی
baghi 85% az zaman o enerzhi serfe yek proseh besyar toulani be naam	باقی 85% از زمان و انرژی صرف یک پروسه بسیار طولانی به نام
amma ageh be ye fenjon ghahve ba shekarniaz dari	اما اگه به یه فنجون قهوه با شکرنیاز داری
dar hal hazer 1/8 milyard nafar javan bayan 10 ta 24 sal dar jahan vojood darand	در حال حاضر، ۱/۸ میلیارد نفر جوان بین ۱۰ تا ۲۴ سال در جهان وجود دارند
tedad nafarati besyar bishtar az tamam majmoeh vezarar kharejeh aamrikaa pas az hamle 11 septambr 2001	تعداد نفراتی بسیار بیشتر از تمام مجموعه وزارت خارجه آمریکا پس از حمله 11 سپتامبر 2001
dar chart saazmaani kagab depaartemaane be naam depaartemaane A vojood dasht	در چارت سازمانی کاگب، دپارتمانی به نام دپارتمان A وجود داشت
har rouz yek doo medad kesh mi rfttm taain ke ta payan term az tamami doustanam medad brdashth bodam	هر روز یک دو مداد کش می رفتتم تااین که تا پایان ترم از تمامی دوستانم مداد برداشته بودم
ke be tazif o khalgh napaidarihai zhaoplitk monjar mishod	که به تعضیف و خلق ناپایداریهای ژئوپلیتک منجر میشود
o migooyam jang ra board bjaii in ke poolash ra dar yek nobat begirad 20 baraabare mablaghe aolih ra pas gereft	و میگویم جنگ را برد، بجایی این که پولش را در یک نوبت بگیرد ۲۰ برابر مبلغ اولیه را پس گرفت
amma in gorooh az afsaraan kagab hanouz vojood dashtand o hkomt jadid rosih aanhaa ra hemaayat mikard	اما این گروه از افسران کاگب، هنوز وجود داشتند و حکومت جدید روسیه آنها را حمایت میکرد
yani 3brabr gheymate ik krolakh albate hichks in poul ro darjaa o naghd pardakht nmiknh	یعنی ٣برابر قیمت یك كرولا،كه البته هیچكس این پول رو درجا و نقد پرداخت نمیكنه
rouz sevom shorou kaaram dar yek astartap por shor dar silikan vali boud aoail sal dohezaraosizdah	روز سوم شروع کارم در یک استارتآپ پر شور در سیلیکان ولی بود اوایل سال ۲۰۱۳
msri ast o ba boudan atraf on ma niaz mobtala mishavim	مسری است، و با بودن اطراف آن ما نیز مبتلا میشویم
jal etelaat -tasirgzari boro o ya eijad afrad mosr boro afkaare omoomi ainfloansr	جعل اطلاعات -تأثیرگذاری بر، و یا ایجاد افراد مؤثر بر افکار عمومی (اینفلوئنسر)
yeki az in afsaraan javan ke dar 1975 be estekhdam kagab dramdh boud velaadimir pootin boud	یکی از این افسران جوان که در 1975 به استخدام کاگب درآمده بود ولادیمیر پوتین بود
chegouneh dar mshahdat tajrobeye ma ta sal 2015 boro asas sranh tolid nakhals meli rshd mikonand	چگونه در مشاهدات تجربی ما تا سال ۲۰۱۵ بر اساس سرانه تولید ناخالص ملی رشد میکنند
har ozv kagab movazaf boud 25% az zaman khod ra dar hrroz	هر عضو کاگب موظف بود 25% از زمان خود را در هرروز
saei karde yek keshti 107 mtri ra begirad dar halikh afsaraan niroi driaii ba tfnghai bozorg dar keshti boodand	سعی کرد یک کشتی ۱۰۷ متری را بگیرد در حالیکه افسران نیروی دریایی با تفنگهای بزرگ در کشتی بودند
ageh bkhai rghs foks trot ya tango tamrin kony	اگه بخای رقص فوکس تروت یا تانگو تمرین کنی
man tou rdiabi shekaar kaaram tkm	من تو ردیابی شکار کارم تکم
faramoush nakonid ke afsaraan kagab 25% az zaman khod ra serfe tolid etelaat ghlt mikardand	فراموش نکنید که افسران کاگب 25% از زمان خود را صرف تولید اطلاعات غلط میکردند
zira baray avalin baar dar toul tarikh ma ham zaman panj nslha ra dar adarat darim betor ghiramdi	زیرا برای اولین بار در طول تاریخ، ما هم زمان پنج نسلها را در ادارات داریم، بطور غیرعمدی
nahaa motaabegh mosaahebe shnakhti prssh mishod	نها مطابق مصاحبه شناختی پرسش میشود
khdahafz ordibehesht 97 baazam tekrar sho o tnham nzar	خداحافظ اردیبهشت ۹۷ ، بازم تکرار شو و تنهام نزار
be aanhaa ehsas arzesh ghadrdaani o mavared tavajoh boudan bedahid	به آنها احساس ارزش، قدردانی و مورد توجه بودن بدهید
ghabl az man 100 nafar digeh	قبل از من 100 نفر دیگه
pesarak pedarbozorgash ra tamaashaa karde ke namh ie mi nevesht	پسرک پدربزرگش را تماشا کرد که نامه ای می نوشت
inja ye polo tou brzilh ke 30 motor artfaa dareh	اینجا یه پل تو برزیله كه ٣٠ متر ارتفاع داره
soal sadhai ast o che bedaanid che nadaanid	سوال سادهای است، و چه بدانید چه ندانید
bikhial rich fahmidam digeh	بیخیال ریچ فهمیدم دیگه
in tajrobe ra dashtim	این تجربه را داشتیم
digeh hosele am ro sar aordin fekr mi kardam misheh bahaton maamlh karde	دیگه حوصله ام رو سر آوردین. فکر می کردم میشه باهاتون معامله کرد.
anfjar dar rbat karrim 4 oahd mskoni tkhrib o 9 nafar msdom shdand	انفجار در رباط کریم ۴ واحد مسکونی تخریب و ۹ نفر مصدوم شدند
az mah ramezan faghat 27 rouz mimonh	از ماه رمضان فقط 27 روز میمونه
yani mikham begam dashtane graish siasi tou in kshor az kar tou madnm skht trh	یعنی میخوام بگم داشتن گرایش سیاسی تو این كشور، از كار تو معدنم سخت تره
shmam hmchin madrshohri daarin	شمام همچین مادرشوهری دارین؟
nesf shrktknndgan listi daryaft kardeand ke 15 loghat baray shorou biadbi dasht	نصف شرکتکنندگان لیستی دریافت کردند که ۱۵ لغت برای شروع بیادبی داشت
bayad begouim gorooh angshtshmari az koneshgarha hast	باید بگویم گروه انگشتشماری از کنشگرها هست
chnd rouz bad paadeshah ba mlazmansh baray shekaar be nazdiki jngli rftnd	چند روز بعد پادشاه با ملازمانش برای شکار به نزدیکی جنگلی رفتند
gzarshhai in kargrouh be dast vazir kharejeh reside o ou in gzarshhai ra be mikhaail gorbachof dad	گزارشهای این کارگروه به دست وزیر خارجه رسید و او این گزارشهای را به میخائیل گورباچوف داد
az kode takhfif estefadeh kon	از کد تخفیف استفاده کن
avalin daahai sal nodo hfte	اولین دعاهای سال نودو هفت
man oaghan ta'ajob mikonam vaghti mishnavam dokhtary 2 milion khrej rang mohash kardeh	من واقعن تعجب میکنم وقتی میشنوم دختری 2 میلیون خرج رنگ موهاش کرده
tm ham mjbori ghabool kony	تم هم مجبوری قبول کنی
aya az tarigh modiriat be takhir dast zadand aya feshar vared kardeand	آیا از طریق مدیریت به تغییر دست زدند؟ آیا فشار وارد کردند؟
misham kashef ershad srzminai davar aftadh	میشم کاشف ارشد سرزمینای دور افتاده
sazmanhaii hmchon sazman ma ke baray hghogh msrfknndgan mobaareze mikonad	سازمانهایی همچون سازمان ما که برای حقوق مصرفکنندگان مبارزه میکند
javanan 25 darsad jmait hastand	جوانان ۲۵ درصد جمعیت هستند
baahaat ziad harfe mizaneh	باهات زیاد حرف میزنه
manzoor ma che farghi dasht	منظور ما چه فرقی داشت؟
dar chart saazmaani kagab depaartemaane be naam depaartemaane A vojood dasht	در چارت سازمانی کاگب، دپارتمانی به نام دپارتمان A وجود داشت
shoharjan migoft chandtashoun ham azashoun koli kharide kardeh boudan	شوهرجان میگفت چندتاشون هم ازشون کلی خرید کرده بودن
naam shoma chist fin mirestad oh fin	نام شما چیست؟ فین میرستاد: اوه، فین
dorosteh dorosteh mi donestam	درسته درسته .می دونستم
emkan nadaare mageh momkeneh ba aghl o mantegh jor dar nemiad	امکان نداره؟ مگه ممکنه؟ با عقل و منطق جور در نمیاد.
esme un iaro chi boud	اسم اون یارو چی بود ؟
» apl mashghoole kar kardan rouye on ast	» اپل مشغول کار کردن روی آن است
in kheili shirine o hasaseh	این خیلی شیرین و حساسه
ghabl az inke parvaaz kony	قبل از اینکه پرواز کنی
bayad mashin ro brgrdonm	باید ماشین رو برگردونم
vali ma fekr mikonim ke shodani ast	ولی ما فکر میکنیم که شدنی است
haman kargrouh kouchak niaz jedi gerfte nemishod	همان کارگروه کوچک نیز جدی گرفته نمیشد
matne khodkoshi vojood dashth	.متن خودکشی وجود داشته
ziba khanoum mi geh khabeh kojan baghieh	زیبا خانوم می گه خوابه کجان بقیه؟
giah shnasi ke mi khoad anoaa giaha ro be sourat fhrst namh dar biarh	گیاه شناسی که می خواد انواع گیاها رو به صورت فهرست نامه در بیاره
aina chikar mi knn	اینا چیکار می کنن؟
shhadt mard hizm shkni ke dar klantri azao bazprsi shodeh boud	شهادت مرد هیزم شکنی که در کلانتری ازاو بازپرسی شده بود
az on pessar porsid aya baray behboodi khaahart haazeri be un khoon ehda kony	از آن پسر پرسید: آیا برای بهبودی خواهرت حاضری به اون خون اهدا کنی؟
az akharin tlash hay sdasima baray jazab mkhatb	از آخرین تلاش های صداسیما برای جذب مخاطب
amma shoma khodetoon gftin	اما شما خودتون گفتین
mogheeat hay nakhosh ra be khoobi be mogheeat khob trbiti tabdil konim	موقعیت های ناخوش را به خوبی به موقعیت خوب تربیتی تبدیل کنیم
man ke mesle shoma azad nistam	من که مثل شما ازاد نیستم.
in oiros siasi pas az nofooz bharami doshmane khod ra az daroon naabood mikard	این ویروس سیاسی، پس از نفوذ، بهآرامی دشمن خود را از درون نابود میکرد
asla mail naboodam ba prhrfi oghtgzrani konam	اصلا مایل نبودم با پرحرفی وقتگذرانی کنم
bodo elias ye khordeh shokolaat behem bedeh	بدو الیاس، یه خورده شکلات بهم بده
hamchenin masraf konandegan nemitavaanand in kar ra khoudeshan anjam dahand	همچنین مصرف کنندگان نمیتوانند این کار را خودشان انجام دهند
ben avalin ghadam hasho dorost bardaasht	بن اولین قدم هاشو درست برداشت
hal adhai shayad astdlal konand ke tghiirat o arzshhai eijad shodeh az soi aanhaa zata kootaahe modat hastand	حال، عدهای شاید استدلال کنند که تغییرات و ارزشهای ایجاد شده از سوی آنها، ذاتا کوتاه مدت هستند
chap o nshr mghalat drough dar nshriat matbr	چاپ و نشر مقالات دروغ در نشریات معتبر
ye madrshohr daram doost dareh manoo hameh jabakhodsh bbrh o pz manoo bedeh	یه مادرشوهر دارم: دوست داره منو همه جاباخودش ببره و پز منو بده
raazi nabayad binshon basheh	رازی نباید بینشون باشه
ageh bkhai rghs foks trot ya tango tamrin kony	اگه بخای رقص فوکس تروت یا تانگو تمرین کنی
asla mail naboodam ba prhrfi oghtgzrani konam	اصلا مایل نبودم با پرحرفی وقتگذرانی کنم
tamam shab tou ataghm boudeh	.تمام شب تو اتاقم بوده
hala ke hameh sefaareshe dadan	حالا که همه سفارش دادن
mohemtar inke ghm o narahati hay paiiz gozashte ro ham paak karde	مهمتر اینکه غم و ناراحتی های پاییز گذشته رو هم پاک کرد.
manam bayad bargardam sar kar	منم باید برگردم سر کار
javanan az ma barnameh dars o thsil hamzaman mikhahand	جوانان از ما برنامه درس و تحصیل همزمان میخواهند
nime i aval tamoom shod	نیمه ی اول تموم شد
na man nistam khdahafz -	نه من نیستم خداحافظ -
tou ye mosaahebe digeh dari	تو یه مصاحبه دیگه داری
baray ketab kharidan lebas kharidan	برای کتاب خریدن، لباس خریدن
na be tou rftnt na be in biroon aomdnt	نه به تو رفتنت. نه به این بیرون اومدنت.
mesle adidas adidas aghianos ra tamiz mikonad o dar in fraind poul dar miaord	مثل آدیداس: آدیداس اقیانوس را تمیز میکند و در این فرایند پول در میآورد
aasf rafteh shayad elias nfhmh	عاصف رفته شاید الیاس نفهمه
oh behtaere az in nemishod	اوه بهتر از این نمیشد
hmoni ke behesh chp chp negah mi kardie un saham mnh gofteh basham	همونی که بهش چپ چپ نگاه می کردی. اون سهم منه. گفته باشم.
doktor oinbrg ghol dadidn	دکتر وینبرگ قول دادیدن
jdidtrin model lebas monaaseb baray madrbzrga kalkshn zemestan	جدیدترین مدل لباس مناسب برای مادربزرگا، کالکشن زمستان
hich fekr nemikardam ke vey be chenin srnoshti dchar mishod	هیچ فکر نمیکردم که وی به چنین سرنوشتی دچار میشود
aanhaa ra boland boland khoandim jrian azmayesh be sourat zendeh dar sait ma	آنها را بلند بلند خواندیم، جریان آزمایش به صورت زنده در سایت ما
bia doubareh emtehaan konim	بیا دوباره امتحان کنیم
shaar bachegi ma in boud ke dkhtrha moshand o psrha shirnd	شعار بچگی ما این بود که دخترها موشاند و پسرها شیرند
mah rmzon tamoom shod o emrouz eyd ftrh	ماه رمضون تموم شد و امروز عید فطره
masuliat che kesani ast booom in adamha	مسئولیت چه کسانی است؟ بوووم! این آدمها
in iaro drough migeh shoma chera bavar mi knin tou ro khoda yeki manoo nejat bedeh	این یارو دروغ میگه شما چرا باور می کنین. تو رو خدا یکی منو نجات بده.
yek mard roostaayi ba baar sbzijat be nazdik sang reside	یک مرد روستایی با بار سبزیجات به نزدیک سنگ رسید
mardom jigh mizadan	مردم جیغ میزدن
agar harkas betavand az tarigh in vasael vared manzel shoma shood	اگر هرکس بتواند از طریق این وسایل وارد منزل شما شود
madrbzrg hshtad o hfte salham rouzi dah baar migeh razim be rzai khoda o amadhi marg	مادربزرگ هشتاد و هفت سالهام روزی ده بار میگه راضیم به رضای خدا و امادهی مرگ
baray ye modat kheili toulani	برای یه مدت خیلی طولانی
javanan hamchenin migouyand ke mikhahand saayer javanan ra komak konand	جوانان همچنین میگویند که میخواهند سایر جوانان را کمک کنند
hti jana partnrz haman gnsgtrhai asile ke jan aanhaa ra hramzadhhai tmaa minamd	حتی جانا پارتنرز، همان گنسگترهای اصیل که جان آنها را حرامزادههای طماع مینامد
na agha hich chiz faghat yek rismaan peyda kardam ke kenar rishe drkht azad aftadh boud	نه اقا، هیچ چیز، فقط یک ریسمان پیدا کردم که کنار ریشه درخت ازاد افتاده بود
tou ke asla aono nkhondi	تو که اصلا اونو نخوندی
man bache ke bodam ashegh gol bodam	من بچه که بودم عاشق گل بودم
velash kon kshtish hala ghltih ke kardeh	ولش کن. کشتیش. حالا غلطیه که کرده.
barkhi az bzrgan srotmnd ba kaaleske hay khod be kenar sang residand	برخی از بزرگان ثروتمند با کالسکه های خود به کنار سنگ رسیدند.
aknoon tavanaei ada kardan bdhkarish ra darad vali takhir mi andazd	اکنون توانایی ادا کردن بدهکاریش را دارد ولی تاخیر می اندازد
tou brfa draz keshidam	تو برفا دراز کشیدم
vaase tou o amili emshab	.واسه تو و امیلی. امشب
chetoure ejaze midi doroztmam ye moush ke aslaa maloom nist nrh ya maaede biad touye khuneh	چطور اجازه میدی دوروزتمام یه موش که اصلاً معلوم نیست نره یا ماده بیاد توی خونه؟
gorooh mozik mshhorh	گروه موزیک مشهوره؟
hamash doost daram harfe bznmhrf donm kheili por shodeh	همش دوست دارم حرف بزنم،حرف دونم خیلی پر شده
khob khanom ha o aghayan	خوب ، خانمها و آقایان
nemitoonim ba ham bashim	.نمیتونیم با هم باشیم
khob inam ghahve khonst	.خوب ، اینم قهوه خونست
khodmm mondm che jouri mitoonam zendeh bemoonam	خودمم موندم چه جوری میتونم زنده بمونم
nemi tonam in karo bokonam	نمی تونم این کارو بکنم
in maarfh man dar aanjaa boud	این معارفه من در آنجا بود
hich lbasi peyda nemikonim	هیچ لباسی پیدا نمیکنیم
marj ye doost dokhtar dareh	مارج یه دوست دختر داره
digeh nemisheh baahaat tou yek otagh o zire yek saghf zendegi karde	دیگه نمیشه باهات تو یک اتاق و زیر یک سقف زندگی کرد
amma dar vaaghe modiriat ra oadar be eijad tghiirati nemikonand ke mohit zist o ajtmaa ra takhir khahad dad	اما در واقع مدیریت را وادار به ایجاد تغییراتی نمیکنند که محیط زیست و اجتماع را تغییر خواهد داد
kasb o kari ke arzesh on dar hodoude se milion dolar dar sal ast	کسب و کاری که ارزش آن در حدود سه میلیون دلار در سال است
ma vasael kaafi niaordim	ما وسایل کافی نیاوردیم
brai hrdstgah khodroi oardati	براى هردستگاه خودروى وارداتى
ou ghlh i everest ra davar mi znd	او قله ی اورست را دور می زند
tou yeki az daneshgah hay tehran ghabool shodam	تو یکی از دانشگاه های تهران قبول شدم
o dokhtaran be man migouyand	و دختران به من میگویند
sepas yek nafar digar ra jelo miandakhtnd ta az hrfhaishan dfaa konad	سپس یک نفر دیگر را جلو میانداختند تا از حرفهایشان دفاع کند
man ashegh monikai mstm	من عاشق مونیکای مستم
paap koja zendegi mi knh-	پاپ کجا زندگی می کنه؟-
nazdik digeh che mzkhrfih	نزدیک دیگه چه مزخرفیه
o taghsir raychel ham nistsh	.و تقصیر ریچل هم نیستش
dari kheili skhtsh mi kony	!داری خیلی سختش می کنی
na mikham zobesh knm-	.نه ، میخام ذوبش کنم-
bezaar ye baar ghablesh bokonam	.بزار یه بار قبلش بکنم
az kheili hashnidm ke migan	از خیلی هاشنیدم که میگن
man ham az didanet khoshhaalam	من هم از دیدنت خوشحالم
jaiikh shkhsa ahameiat midahid amma mostaghim be chalesh ham mikeshid	جاییکه شخصا اهمیت میدهید، اما مستقیم به چالش هم میکشید
amrikaii vaghti ba aadam harfe mizaneh ke oaghaa kari dashth basheh	آمریکایی وقتی با آدم حرف میزنه که واقعا کاری داشته باشه
mi donm chi fekr mi kony	.می دونم چی فکر می کنی
o zan hay bd az zan hay khob mshkhsh	و زن های بد از زن های خوب مشخصه
haminjoori oonja nshinin manoo negah knin	همینجوری اونجا نشینین منو نگاه کنین
tou boudi ke tmomsh kardie	تو بودی که تمومش کردی
bara inke sbor nbodi	برا اینکه صبور نبودی ؟
behesh bego man hasasiat daram	بهش بگو من حساسیت دارم
in khuneh mard dareh sarvar dareh	این خونه مرد داره. سرور داره.
ta tghiirat baray behbood mohit zist o ajtmaa emaal shood	تا تغییرات برای بهبود محیط زیست و اجتماع اعمال شود
ta hala savaar ye khuneh i parandeh nashode bodam	تا حالا سوار یه خونه ی پرنده نشده بودم
o edameh dasht ta afsaraan niroi driaii aslhh kshidnd o amliat be payan reside	و ادامه داشت تا افسران نیروی دریایی اسلحه کشیدند و عملیات به پایان رسید
man bayad baahaat harfe bezanam	من باید باهات حرف بزنم
tou in ja chi kar mikoni	تو این جا چی کار میکنی؟
kar ma be onvan hampeymaan in ast ke rizkhoshounatha ra beshnasim o anjameshan nadehim	کار ما به عنوان همپیمان این است که ریزخشونتها را بشناسیم و انجامشان ندهیم
sedaye kherade shodan nan khoshk be goush mi rsd	صدای خرد شدن نان خشک به گوش می رسد
man o shoma mitavanim baray hamdigar hampeymaan shavim che dar mohit kar bashim che biroon	من و شما میتوانیم برای همدیگر همپیمان شویم، چه در محیط کار باشیم چه بیرون
khnde faghat raftan tou bzrgrah o gsht zadan	(خنده) فقط، رفتن تو بزرگراه و گشت زدن
un tou raftan cheghadr mitoone zajr aavare basheh	اون تو رفتن چقدر میتونه زجر آور باشه.
in masire ra be ma midahad	این مسیر را به ما میدهد
gerfte boud baraam biari	گرفته بود برام بیاری ؟
oh khodaye man moonika	!اوه ، خدای من! مونیکا
kari krd ke hoadarai baghieh i tim ha betoonan final asia ro az nzdik bebinan	كارى كرد كه هواداراى بقیه ى تیم ها بتونن فینال آسیا رو از نزدیك ببینن
ghaza kooshesh man ghzamo mi khum	غذا کوشش؟ من غذامو می خوام
behet bgn ashghali khoubeh	!بهت بگن آشغالی ، خوبه
bayad beram aamaade besham	باید برم آماده بشم
yek mard roostaayi ba baar sbzijat be nazdik sang reside	یک مرد روستایی با بار سبزیجات به نزدیک سنگ رسید
bebin ghzih az in gharareh	ببین قضیه از این قراره
dar edameh brrsi mikonim ke dar posht pardeh in etefagh che boudeh ast	در ادامه بررسی میکنیم که در پشت پرده این اتفاق چه بوده است
hasan ghsh nakhour darim miaim	حسن غصه نخور داریم میایم
se sal maande be payan mhlt	سه سال مانده به پایان مهلت
bayad sria poul jma konam	.باید سریع پول جمع کنم
anglisi harfe nmiznh	انگلیسی حرف نمیزنه
taasir medad siah dar zendegi doo koudak	تاثیر مداد سیاه در زندگی دو کودک
man ozrkhaahi lazem daram	.من عذرخواهی لازم دارم
kam kam adat kardam be faza o vaghti be khoudam umadam didam ikmah az daneshgah gozashte	کم کم عادت کردم به فضا و وقتی به خودم اومدم دیدم یکماه از دانشگاه گذشته
ma hmchin kari nemi konim	ما همچین کاری نمی کنیم
didn tou kheili aali boud	دیدن تو خیلی عالی بود
vaghti ou ra bazdasht kardam rouye polo az asb be zamin aftadh o minalid	وقتی او را بازداشت کردم روی پل از اسب به زمین افتاده و مینالید
ke mitavaanand tamam ahdaafe tose'e paydar ra naabood konand	که میتوانند تمام اهداف توسعه پایدار را نابود کنند
vaase hamin donbaalash gshtm	.واسه همین دنبالش گشتم
arros nmonhmn arros shodam ke shohrdari knmaros faghat ye vazife darhzn khoobi baray shooharash basheh	عروس نمونه:من عروس شدم که شوهرداری کنم،عروس فقط یه وظیفه داره،زن خوبی برای شوهرش باشه
faghat be meghdaar kami az javanan miresad	فقط به مقدار کمی از جوانان میرسد
msiri shgftangiz bsoi fazaye amliati amn rouye zamin hasl shodeh ast	مسیری شگفتانگیز بسوی فضای عملیاتی امن روی زمین حاصل شده است
in sedaye shoma boud ke srmaihdarha ra dar ohlh aval baojdantr karde	این صدای شما بود که سرمایهدارها را در وهله اول باوجدانتر کرد
asln bfrmaiin khuneh ma	اصلن بفرمایین خونه ما.
be abart digar mitavanim jahani amn o be manai kalame jahan bsazim	به عبارت دیگر، میتوانیم جهانی امن و به معنای کلمه جهان بسازیم
ma mohit modbanhtri darim	ما محیط مودبانهتری داریم
sedaye friadha o zarbeh hay dar az biroon bishtar o bishtar mi shood	صدای فریادها و ضربه های در از بیرون بیشتر و بیشتر می شود
tasavor konid ke che jahan sbztr o behtary khahad shod	تصور کنید که چه جهان سبزتر و بهتری خواهد شد
daaknid aindfah digeh moshkeli pish niad	دعاکنید ایندفعه دیگه مشکلی پیش نیاد
be khater in msalh nist	به خاطر این مسئله نیست
sedaye zarbeh hay mohkam be dar khaneh be goush miresad	صدای ضربه های محکم به در خانه به گوش میرسد
jouri ke bazi az dkhtra rzh lb mizanan ta lbshon bozorgtar be nazar biad	جوری که بعضی از دخترا رژ لب میزنن تا لبشون بزرگتر به نظر بیاد
o barkhi az akhbar khob niaz vojood darad	و برخی از اخبار خوب نیز وجود دارد
salam bebakhshid dir kardam	سلام ، ببخشید دیر کردم
yani jedi ghabool mi kony	یعنی جدی قبول می کنی ؟
por az enerzhi mosbat boud	پر از انرژی مثبت بود
ta ghabl inke hameh chiz kharab besheh bhtrh ye fekr aaghelaane bokonim	تا قبل اینکه همه چیز خراب بشه بهتره یه فکر عاقلانه بکنیم.
galoy pessar ra mi fesharad	گلوی پسر را می فشارد
bhosilh on alayhe aalmaan ghrbi bohraan siasi eijad karde	بهوسیله آن علیه آلمان غربی بحران سیاسی ایجاد کرد
imaan majrajo hmknon vared mi shood	ایمان ماجراجو همکنون وارد می شود
man digeh daram asabi misham	من دیگه دارم عصبی میشم
are sara har chi basheh	.آره سارا ، هر چی باشه
behem ye forsat bedeh ta-	.بهم یه فرصت بده تا-
vaziat javan iraani o mdirsh sar kar	وضعیت جوان ایرانی و مدیرش سر کار
sobh ham ba maman o baba raftim biroon	صبح هم با مامان و بابا رفتیم بیرون
dar baraabare aazaar o tbaiz mohit kar	در برابر آزار و تبعیض محیط کار
har manai frsti ast ta ozaitman ra behbood bkhshim	هر مانعی ، فرصتی است تا وضعیتمان را بهبود بخشیم
khosh oomadi madar bia tou	خوش اومدی مادر. بیا تو.
gofteh dnbalh baznshstgimm	گفته دنباله بازنشستگیمم!
mamnoon mzahm toon shodim	ممنون. مزاحم تون شدیم.
yani dar toul anjam mamoritshan kamlaa dar knarshan bashid	یعنی، در طول انجام ماموریتشان کاملاً در کنارشان باشید
khdabh karshon rongh bedeh	خدابه کارشون رونق بده
dolat faghat ba dramd doo se salsh az mahal varedat khodro	دولت فقط با درآمد دو سه سالش از محل واردات خودرو
vali alaan raftam tou ashpzkhonh didam babam shamsho nakhorde	ولی الان رفتم تو اشپزخونه دیدم بابام شامشو نخورده
dishab az tou khoshshon oomad	دیشب از تو خوششون اومد
msla znhai bd hjab ro ba halthai mokhtalef mizarn ta oaknshhai admharo bebinan	مثلا زنهای بد حجاب رو با حالتهای مختلف میذارن تا واکنشهای آدمهارو ببینن
oh are man ham hamin toor	اوه آره من هم همین طور
drsorti ke khb khaanevaade mnkhodmndostamkli daakrdn o koli nzramahichoght nagoftan makrdim	درصورتی که خب خانواده من،خودمن،دوستام،کلی دعاکردن و کلی نذر،اماهیچوقت نگفتن ماکردیم
in avalin ghadam baray takhir khoudam	این اولین قدم برای تغییر خودم
mrdashon kheili cheshm pakn choun brashon aadi shodeh az bs ke didn	مرداشون خیلی چشم پاکن چون براشون عادی شده از بس که دیدن
- man daram harfe mi znm	- من دارم حرف می زنم
fateme sotoode atfagha in mozoo baray khoudam ham jaaleb boud	فاطمه ستوده: اتفاقا این موضوع برای خودم هم جالب بود
hameh az ghzih bakhbr mishn	همه از قضیه باخبر میشن
man hich vaght be kasi drough nagoftam	من هیچ وقت به کسی دروغ نگفتم
amidoarm baba movafagh besheh	امیدوارم بابا موفق بشه
zan gheymate gldanha ra porsid	زن قیمت گلدانها را پرسید
elias az oonja bia biroon	الیاس، از اونجا بیا بیرون
alaan tou amrika hameh nshstn paye saitha o kanalhai srafiha darn gron shodan rial ro negah mikonan	الان تو امریکا همه نشستن پای سایتها و کانالهای صرافیها دارن گرون شدن ریال رو نگاه میکنن
albate ke lili ro iadmh	البته که لیلی رو یادمه
azash khoasth bodam	ازش خواسته بودم
man kheili behetoon alagheh daram	من خیلی بهتون علاقه دارم.
ageh ghrar nist un chizi ro ke mikham behem bdi	اگه قرار نیست اون چیزی رو که میخوام بهم بدی،
in kheili ohshianh hast	این خیلی وحشیانه هست.
ageh in ghzih dorost basheh	اگه این قضیه درست باشه
un ba nik nemi khoabid	اون با نیک نمی خوابید
be hrhal kasaayi ke tou in veblaag hastan o dastan ha ro mikhoonan ghatan eshgh o tajrobe kardan	به هرحال کسایی که تو این وبلاگ هستن و داستان ها رو میخونن قطعا عشق و تجربه کردن
amma an hangam ke khodavand mi prsd zamani ke doostat dar atsh mi sokht tou che kardie	اما ان هنگام که خداوند می پرسد : زمانی که دوستت در اتش می سوخت تو چه کردی؟
ehsas miknm pirmrdh tou zendegi ghblish kntrl tloizion boudeh	احساس میكنم پیرمرده تو زندگی قبلیش كنترل تلویزیون بوده
ye shohr darim mach kardan ro shmih bandi kardeh	یه شوهر داریم ماچ کردن رو سهمیه بندی کرده
doubareh behet zang mi znm	.دوباره بهت زنگ می زنم
bazi dostanh i mfidi ro ba kshorai digeh bargozaar kardim	بازی دوستانه ی مفیدی رو با کشورای دیگه برگزار کردیم
naghsham in boud ke dar manzar aam karamozi konam o dar khafa morabbigari	نقشم این بود که در منظر عام کارآموزی کنم و در خفا مربیگری
fekr mi konam betunam befahmam	فکر می کنم بتونم بفهمم
faghat inghadr tarsnaak naboud	فقط اینقدر ترسناک نبود
vaghti migan maahi ndh dastesh behesh mahigiri yad bedeh	وقتی میگن ماهی نده دستش، بهش ماهیگیری یاد بده
tou be tamrin niaz dari	تو به تمرین نیاز داری
hamchenin shghlhaii ke hanouz abdaa nshdhand	همچنین شغلهایی که هنوز ابداع نشدهاند
nmikhoai bebini tosh chieh	نمیخوای ببینی توش چیه؟
doost daarin hamishe dast zoor ro srton basheh	دوست دارین همیشه دست زور رو سرتون باشه؟
hala meli pooshan dokhtar valibal iran dar mian chehel tim bartar jahan hastand	حالا ملی پوشان دختر والیبال ایران در میان چهل تیم برتر جهان هستند
srdrgm bodam amidm az hameh ja ghta shodeh boud	سردرگم بودم، امیدم از همه جا قطع شده بود
mageh tou khbar ndari shab o rouz baraat bitabm	مگه تو خبر نداری شب و روز برات بیتابم؟
chera harfe goush nemi kony	چرا حرف گوش نمی کنی؟
misheh lotf kony aino begiri	میشه لطف کنی اینو بگیری؟
ageh gharareh kasi az in khuneh brh shoma hastin	اگه قراره کسی از این خونه بره شما هستین.
amma bad az chnd modat ba tars o vahshat biroon mi znd	اما بعد از چند مدت با ترس و وحشت بیرون می زند
ta tasirgozaari ejtemaai in nhadhai behdashti ra afzaayesh dahim	تا تاثیرگذاری اجتماعی این نهادهای بهداشتی را افزایش دهیم
bia inja bia inja	.بیا اینجا ، بیا اینجا
ozr khahi pazirofteh misheh	عذر خواهی پذیرفته میشه
jang jhani badi paiani brai zamin khahad boud	جنگ جهانى بعدى پایانى براى زمین خواهد بود
in sokoot arzesh dareh o rouz be rouz ghimtsh balatr mirh pas bi dalil nabayad shksth besheh	این سکوت ارزش داره و روز به روز قیمتش بالاتر میره پس بی دلیل نباید شکسته بشه
zibaayi raayegaan ast	زیبایی رایگان است !
khob bezaar be saeed begam	خوب ، بزار به سعید بگم
bs kon digeh dirmon misheh	بس کن دیگه دیرمون میشه
dorosteh khoobi ziad darhamkhab badihaie ham dareh	درسته خوبی زیاد داره،اماخب بدیهایی هم داره
rzh lbt rouye dhnsh malomh	رژ لبت روی دهنش معلومه
are mal mam mzkhrf boud	آره مال مام مزخرف بود
mikhahand tamam maharathaie lazem baray ayande ra dashth bashand	میخواهند تمام مهارتهای لازم برای آینده را داشته باشند
zani panjah salah por kar o por tlash o tasmim girndh baray ahl mahal	زنی پنجاه ساله پر کار و پر تلاش و تصمیم گیرنده برای اهل محل.
khob sria o bi sar o seda	خوب، سریع و بی سر و صدا
na ye dstgah ghmar bazi	نه یه دستگاه قمار بازی
choun mardom shoma ra be onvan yek shakhs mohem tarkibe mnhsrbh frdi az doo vijegi kelidi mibinnd	چون مردم شما را به عنوان یک شخص مهم ترکیب منحصربه فردی از دو ویژگی کلیدی میبینند
ta az shr un rahat besham	.تا از شر اون راحت بشم
chshmansh rezaa khan boud o man anghlab kbir fransh	چشمانش رضا خان بود و من انقلاب كبیر فرانسه
hes eshtebah khatarnak az amniat	حس اشتباه خطرناک از امنیت
baavaram nemisheh shohr dareh	باورم نمیشه شوهر داره
ma ashegh mosharekat dar msaal rouz hastim	ما عاشق مشارکت در مسائل روز هستیم
man eydeh hay khaasi daram	من ایده های خاصی دارم.
in chizi ast ke ma danshmndan ra zendeh ngh midard	این چیزی است که ما دانشمندان را زنده نگه میدارد
vay az artfaa mi trsm	وای، از ارتفاع می ترسم
man be yek sharike javan o baahoosh motasel shodeh bodam	من به یک شریک جوان و باهوش متصل شده بودم.
hey kari be aghaid mazhabi man ndashth bash basheh	هی کاری به عقاید مذهبی من نداشته باش ، باشه ؟
un che kari boud kardie	اون چه کاری بود کردی ؟
amma srakhr va dadand	اما سرآخر، وا دادند
che jouri etefagh miafth	چه جوری اتفاق میافته؟
bzarin bebinam chi chi migeh bego bego che blaii srt avardan	بزارین ببینم چی چی میگه. بگو بگو چه بلایی سرت آوردن؟
vali hamchenin biandazh saade mitavan ba zaman az yad board	ولی همچنین بیاندازه ساده میتوان با زمان از یاد برد
o un be tou chizi ngh	و اون به تو چیزی نگه ؟
ghaaedi shanbe mirh madrese ya mimonh khuneh bazi perspolise ro mibinh	قائدی شنبه میره مدرسه یا میمونه خونه بازی پرسپولیس رو میبینه؟
ie baba man chi migam shoma chi migi	ای بابا. من چی میگم. شما چی میگی؟
kheili ham chiz mhmi nist	خیلی هم چیز مهمی نیست
ya mitavand mian frzndantan bashad pas frzndantan ba frsthai baraabare rshd mikonand	یا میتواند میان فرزندانتان باشد، پس فرزندانتان با فرصتهای برابر رشد میکنند
ageh betunam oabstgih shdidm be shohr jan ro kam konam hameh chi aali misheh	اگه بتونم وابستگیه شدیدم به شوهر جان رو کم کنم همه چی عالی میشه
in tou nmaishnamh nist-	این تو نمایشنامه نیست-
chera hastam chera mondm chjori taght mi arm	چرا هستم؟ چرا موندم؟ چجوری طاقت می ارم؟
touye ye otagh band nmishn	توی یه اتاق بند نمیشن
amma ro hrfm hastam ke ghibt nknm	اما رو حرفم هستم که غیبت نکنم
tasmim migirand moshkel haml o naghl ra hol konand baray maloolaan jamahshan	تصمیم میگیرند مشکل حمل و نقل را حل کنند برای معلولان جامعهشان
tou ro khoda khaahesh mikonam	تو رو خدا خواهش میکنم
un ye doost dokhtar dareh	اون یه دوست دختر داره
khoda be maar pa nemi dah zaboon mi dah	خدا به مار پا نمی ده، زبون می ده.
o yek moalem madrese rahnmaii ke be aanhaa dar mavared tknolozhi dijital amouzesh midahad	و یک معلم مدرسه راهنمایی، که به آنها در مورد تکنولوژی دیجیتال آموزش میدهد
aya rahbaran jahani midannd ke che chizi ra se sal pish dar mjma omoomi amza krdhand	آیا رهبران جهانی میدانند که چه چیزی را سه سال پیش در مجمع عمومی امضا کردهاند
msla begiri bkhoabi sobh hmchin jaei bidar shi	مثلا بگیری بخوابی صبح همچین جایی بیدار شی
hala montazer doo bazi badmon ba aspania o prtghalim o omid be so'ood darim	حالا منتظر دو بازی بعدمون با اسپانیا و پرتغالیم و امید به صعود داریم
agar betor jedi mtahd shavand ta kari konand	اگر بطور جدی متعهد شوند تا کاری کنند
falaa tshiia jnazhst	فعلاً تشییع جنازهست
chetoure az on estefadeh konad	چطور از آن استفاده کند؟
man chizi nemigam dhnm ghrsh	من چیزی نمیگم. دهنم قرصه.
mesle un mardhaa hastam	مثل اون مردها هستم.
un jabe ro bezaar zamin	!اون جعبه رو بزار زمین
shayad khtkshm moshkel dareh	شاید خطکشم مشکل داره
ozift chieh khordan o khoabidn in jlf bazia ro bezaar kenar be fekr ye lghmh non bash	وظیفت چیه؟ خوردن و خوابیدن؟ این جلف بازیا رو بزار کنار به فکر یه لقمه نون باش.
beshin amnhkhodm dar ro baz mi konam	بشین امنه.خودم در رو باز می کنم.
neshoon midi rahat nistam	نشون میدی ، راحت نیستم
ma alaan kheili balaiim	ما الان خیلی بالاییم
vaghean kheili bashaori in raftaar bashar dostanto faramoush nemi konam	واقعاً خیلی باشعوری. این رفتار بشر دوستانتو فراموش نمی کنم.
mikhahand tknolozhi dijital o sabz ra biamouzand	میخواهند تکنولوژی دیجیتال و سبز را بیاموزند
chehre i aksrit gharib be etefagh asaatid fizike paaye dar daneshgah	چهره ی اکثریت قریب به اتفاق اساتید فیزیک پایه در دانشگاه
ba in khuneh i ghadimi khodaahaafezi konam	با این خونه ی قدیمی خداحافظی کنم
bazi oghtam ye khab nakhoshayand mibini o bad az in ke bidar mishi khdaroshkr mikoni ke vaghei nbodh	بعضی وقتام یه خواب ناخوشایند میبینی و بعد از این که بیدار میشی خداروشکر میکنی که واقعی نبوده
az man yaadegaari dashth baashin	از من یادگاری داشته باشین
un vaghean drdnak boud	اون واقعاً دردناک بود
chieh khb khoudam didam tou sfrh khuneh	چیه خب، خودم دیدم تو سفره خونه.
ma sroishai khoobi darim	ما سرویسهای خوبی داریم
migam misheh doubareh begid	میگم، میشه دوباره بگید
oonvaght manam misham hamkaarat	اونوقت منم میشم همکارت
panj dolar baray har jabe	.پنج دلار برای هر جعبه
sepas dar goshh ie ghaayem shod ta bbind che kasi on ra az masire brmidard	سپس در گوشه ای قایم شد تا ببیند چه کسی آن را از مسیر برمیدارد
digeh hichi brash mohem nist in hata bozorg ham besheh ye milyard dashth basheh be hamin rahati mibkhshh	دیگه هیچی براش مهم نیست این حتا بزرگ هم بشه یه میلیارد داشته باشه به همین راحتی میبخشه،
ma ba ham rabeteh darim	ما با هم رابطه داریم ؟
be zan daare o bi zan nist khilia shoono ainjorin	به زن دار و بی زن نیست خیلیا شون اینجورین
man faghat inja kar mikonam	من فقط اینجا کار میکنم
vali janson oaghaa hasaseh	ولی جانسون واقعا حساسه
misheh hasan hmrahmon biad	میشه حسن همراهمون بیاد؟
bikhod khodtono khsth nkninnmitonin bnoisinhrchi noshtin paak knin	بیخود خودتونو خسته نکنین،نمیتونین بنویسین،هرچی نوشتین پاک کنین
un kheili zoud baorh	اون خیلی زود باوره
poul belit dar jibm maand	پول بلیط در جیبم ماند
ba garanti kaml bazi oghtha baste be sharayet bazar o reghaabat	با گارانتی كامل، بعضی وقتها بسته به شرایط بازار و رقابت
zibaayi navar ast o penhan nemimaanad	زیبایی نور است و پنهان نمیماند
amma be hich ojh na motavajeh mishd o na dast bardar boud	اما به هیچ وجه نه متوجه میشد و نه دست بردار بود
ke mikhoai bala biari	که میخوای بالا بیاری ؟
be hamin khater ba yek board o yek baakht momkene ast jaayegaahe tim ha jabja shood	به همین خاطر با یک برد و یک باخت ممکن است جایگاه تیم ها جابجا شود
ageh alaan boud un chehel nafar shish sdta shekayat azt mi kardan maman	اگه الان بود اون چهل نفر شیش صدتا شکایت ازت می کردن مامان.
engaar chharshnbh sori boud engaar eyd boud shabih hameh chiz boud aonshb	انگار چهارشنبه سوری بود انگار عید بود شبیه همه چیز بود اونشب !!
in mavaared be faarsi brgrdanshdhand	این موارد به فارسی برگردانشدهاند
man nghsh midarm baba	من نگهش میدارم ، بابا
ye madrshohrdarm ageh az dastesh naaraahat basham kheili rahat mitoonam behesh bgmkhili rahat mitoonam baahaash bahs konam	یه مادرشوهردارم: اگه از دستش ناراحت باشم خیلی راحت میتونم بهش بگم،خیلی راحت میتونم باهاش بحث کنم
choun injouri sigar ro dast shrkta baad miknh bad majbour mishn arzon bfroshn	چون اینجوری سیگار رو دست شركتا باد میكنه، بعد مجبور میشن ارزون بفروشن
drbarh oaldinm mi donh	درباره والدینم می دونه
dghaigh aval feshar ziadi ro baziknamon boud o be tarz vahshatnaaki astrs dashtim	دقایق اول فشار زیادی رو بازیکنامون بود و به طرز وحشتناکی استرس داشتیم
o az nazar saazmaani chegouneh mitavanid sharaayeti khalgh konid	و از نظر سازمانی، چگونه میتوانید شرایطی خلق کنید
perspolise bbrh ba shor o hayajan mirim be astghbal thrimha	پرسپولیس ببره با شور و هیجان میریم به استقبال تحریمها
dar mavared inke che chiz shodani ast o nshdni	در مورد اینکه چه چیز شدنی است و نشدنی
tahala touye amrm didam	تاحالا توی عمرم دیدم
baray ye modat bd nist ye tnoai eijad misheh	برای یه مدت بد نیست یه تنوعی ایجاد میشه
ta dar mavared esteraatezhi ke be aatghadm baray sherkat dorost boud tozih daham	تا در مورد استراتژی که به اعتقادم برای شرکت درست بود توضیح دهم
in bishhai az ney o kheyzaraan ast	این بیشهای از نی و خیزران است
tjma admaii ke azshghlshon mtnfrn amabhsh majbour omhkom	تجمع آدمایی که ازشغلشون متنفرن امابهش مجبور ومحکوم!
alaan ehsas behtary dari	الان احساس بهتری داری؟
khodaya komakam kon	خدایا کمکم کن
piremarde faghiri ke behtarin mard jahan shenaakhte shod	پیرمرد فقیری که بهترین مرد جهان شناخته شد
faghat aonjash ke doubareh nafas migirh o zoor mizaneh	فقط اونجاش که دوباره نفس میگیره و زور میزنه
man mi khum komak konam	من می خوام کمک کنم
tohin konid bitojhi konid ya nadide begirid	توهین کنید، بیتوجهی کنید یا نادیده بگیرید
ye kam khshkh vali hameh azash	یه کم خشکه ولی همه ازش
alsh ta mantoba ye angshtr o safar kish	ال:سه تا مانتو،با یه انگشتر و سفر کیش
vaghti yek srmaihgzar agah pidaish mishod	وقتی یک سرمایهگذار آگاه پیدایش میشود
ta inke saregh hrfh ie shodam	تا اینکه سارق حرفه ای شدم
chieh setaare dnbalh daare	چیه ستاره دنباله دار؟
mitavaanand be shoma paasokh dahand hti vaghti tasmim darid nashnas bmanid	میتوانند به شما پاسخ دهند حتی وقتی تصمیم دارید ناشناس بمانید
shayad se rouz dighshaid se hafteh digeh o ya shayad chndmah bad	شاید سه روز دیگه،شاید سه هفته دیگه و یا شاید چندماه بعد
na tamoom nist ta vaghti	نه ، تموم نیست تا وقتی
inja aintori baghal kon	اینجا، اینطوری بغل کن
ye sham mkhtsr dorost koneh	.یه شام مختصر درست کنه
ou dar hal sohbat rah raft o az mdiransh niaz hamin togha ra dasht	او در حال صحبت راه رفت، و از مدیرانش نیز همین توقع را داشت
man be kioi alrzhi daram	من به کیوی آلرژی دارم
ba aoloitbndi harime khosusi o amniat aanhaa mitavaanand etemaad o vafaadaari dar kaarbaraane khod eijad konand	با اولویتبندی حریم خصوصی و امنیت، آنها میتوانند اعتماد و وفاداری در کاربران خود ایجاد کنند
madrshohrshmahm ye karaii mikone iahrfaii mizaneh ke baes besheh pesaresh o ya atrafian behesh madyoon bashan	مادرشوهرشماهم یه کارایی میکنه یاحرفایی میزنه که باعث بشه پسرش و یا اطرافیان بهش مدیون بشن؟
ye lahze goushi ro negahdaar	یه لحظه گوشی رو نگهدار
mi khoad estefadeh koneh	می خواد استفاده کنه ؟
paadeshah az in skhn vazir brashft o az raftaar ou dar baraabare in etefagh azrdh khater shod	پادشاه از این سخن وزیر براشفت و از رفتار او در برابر این اتفاق ازرده خاطر شد.
ghalam ra rouye kaaghaz gozashtam mikhastam be ou befahmaanam ke kar fori o foti daram	قلم را روی کاغذ گذاشتم، میخواستم به او بفهمانم که کار فوری و فوتی دارم
be shomaahaa ham begam kachal bshid	به شماها هم بگم کچل بشید
man un ro yek shbh noshtm	من اون رو یک شبه نوشتم
salam imaan salam imaan	سلام ایمان. سلام ایمان
na na baziro kharab nakon	نه نه بازیرو خراب نکن
ma alaan kheili balaiim	ما الان خیلی بالاییم
man ghbla aintori naboodam	من قبلا اینطوری نبودم
pas digeh naaraahat nisti	پس دیگه ناراحت نیستی؟
hasht ta jojeh darim	هشت تا جوجه داریم
az kode takhfif estefadeh kon	از کد تخفیف استفاده کن
be khodet negah kon	به خودت نگاه کن!
baray man yekam shokr brizid	برای من یکم شکر بریزید
bayad havaasash roprt konim	باید حواسش روپرت کنیم
mi tonam in karo bokonam	.می تونم این کارو بکنم
bad ye modat adat mi kony	بعد یه مدت عادت می کنی
khuneh man booye ajibi midh	خونه من بوی عجیبی میده
akhh digeh hrchizi hedie dareh khoda	آخه دیگه هرچیزی حدی داره خدا
ntrs pessar shjaa ntrs kari be kaart nadaram mi khndd	نترس پسر شجاع. نترس کاری به کارت ندارم. می خندد
shloart ro taraf man nagir	شلوارت رو طرف من نگیر
chikar daarin mi knin	چیکار دارین می کنین ؟
un alaan oaghaa narahth	اون الان واقعا ناراحته
«hml kardan yek oizhgi» dar on lahze chip fahmide amighaa dar drdsr aftadh	«حمل کردن یک ویژگی»؟ در آن لحظه، چیپ فهمید عمیقاً در دردسر افتاده
choun be ma miguyad ke aanhaa negaraanand	چون به ما میگوید که آنها نگرانند
choun ba amalkard khob dar msaal pish ro	چون با عملکرد خوب در مسائل پیش رو
vali un alaan ba imaan hastesh	ولی اون الان با ایمان هستش
azadh labkhand be lb o kheyreh o motafaker az khaneh biroon mi aid	ازاده لبخند به لب و خیره و متفکر از خانه بیرون می اید.
ageh sar o klh i tou peyda nashode boud	اگه سر و کله ی تو پیدا نشده بود
jaei ke adamha mitavaanand biaayand o aidhha o rahhlhaishan ra be ashtrak bgzarnd	جایی که آدمها میتوانند بیایند و ایدهها و راهحلهایشان را به اشتراک بگذارند
tahala pesari behem ebraze alagheh nakardeh boud vabehem pishnahade ashnaii nadadeh boud nemidoonestam chikar konam	تاحالا پسری بهم ابراز علاقه نکرده بود وبهم پیشنهاد اشنایی نداده بود نمیدونستم چیکار کنم
man am goftam kou goush shnoa zhra khanoum ro ke mi shnasi	من ام گفتم. کو گوش شنوا! زهرا خانوم رو که می شناسی!
behtarin barkhord ba ksi ke ashghal mi ndazh biroon	بهترین برخورد با كسی كه اشغال می ندازه بیرون
fibi ye daghigheh sabr kon	فیبی ، یه دقیقه صبر کن
pas tou inja kar mikoni	پس تو اینجا کار میکنی
brgha ra rouye zamin mi rizd khod ra moratab mi konad o be samt dar mi rod	برگها را روی زمین می ریزد خود را مرتب می کند و به سمت در می رود.
o shadish bad az amali kardan in pishnahade chnd baraabare shod	و شادیش بعد از عملی کردن این پیشنهاد چند برابر شد
are o mamnoon mishim	آره و ممنون میشیم
daram miram tou tloizion	!دارم میرم تو تلویزیون
pas mi khoain hmon kot she ro biarin	پس می خواین همون کت ش رو بیارین.
blh ke ba shoma bodam	بله که با شما بودم.
in aks dkhtrth mageh na	این عکس دخترته مگه نه؟
hameh ja vojood darad o nshanhhaii hastand ke bayad eslaahaat sourat gird	همه جا وجود دارد، و نشانههایی هستند که باید اصلاحات صورت گیرد
ye sor o saat mofasal o hameh ram khbar konim	یه سور و سات مفصل و همه رم خبر کنیم.
pashim berim ghnd o shokr o roghnmon ro begirim ta tamoom nashode	پاشیم بریم قند و شکر و روغنمون رو بگیریم تا تموم نشده
vaghti ou ra bazdasht kardam rouye polo az asb be zamin aftadh o minalid	وقتی او را بازداشت کردم روی پل از اسب به زمین افتاده و مینالید
aia ma ham hamin jorim	ایا ما هم همین جوریم؟
saeed migeh mi khoad hasan asir koneh	سعید میگه می خواد حسن اسیر کنه
baraabare rasm khaanevaade hay bozorg mkh mohamad ra be daih ie be naam hlimh sepord	برابر رسم خانواده های بزرگ مکه محمد را به دایه ای به نام حلیمه سپرد.
javaab on ra har rouz ba raftaaretaan midahid	جواب آن را هر روز با رفتارتان میدهید
amma hif ke alaan hssh nistbashh jmah badii	اما حیف که الان حسش نیست،باشه جمعه بعدی
trsi ke dar del yek mdiraaml sherkat o hiat mdirh eijad mikonand	ترسی که در دل یک مدیرعامل شرکت و هیات مدیره ایجاد میکنند
pesari ke salhabod bache daare nmishdo khanoadsh brash koli doa kardan	پسری که سالهابود بچه دار نمیشدو خانوادش براش کلی دعا کردن
znha mi khoannd o sar khoshi mi konand	زنها می خوانند و سر خوشی می کنند.
mdam goshhgirtr mishavid	مدام گوشهگیرتر میشوید؟
sharzh goushi shoma tamam mishod	شارژ گوشی شما تمام میشود
chenaanche ghsm yad karde ke man digar harfi nadaram	چنانچه قسم یاد کرد که من دیگر حرفی ندارم
na ye vasile sargarmi ke	نه یه وسیله سرگرمی که
ke ba mdiraaml o hiat mdirh o har shnondh digari drbarhash harfe mizanad	که با مدیرعامل و هیات مدیره و هر شنونده دیگری دربارهاش حرف میزند
karkonan bishtar az har chiz az rhbranshan che chizi mikhahand	کارکنان بیشتر از هر چیز از رهبرانشان چه چیزی میخواهند؟
raychel ro mamani seda konam	ریچل رو مامانی صدا کنم
chetoure fhmidi man ainjam	چطور فهمیدی من اینجام؟
morchh hameh ro mi khorh jz ghm saheb khuneh ro	مورچه همه رو می خوره جز غم صاحب خونه رو
chetoure momkeneh lng ye moush nim ojbi bshi	چطور ممکنه لنگ یه موش نیم وجبی بشی؟
az mrzhai siarhai tjaoz mikonim	از مرزهای سیارهای تجاوز میکنیم
harfhaayi ke tou ghooti hich atari peyda nemisheh eyneh ke amrikaainghdr pishrafte kardeh	حرفهایی که تو قوطی هیچ عطاری پیدا نمیشه اینه که امریکااینقدر پیشرفت کرده
motorhai jstjo dar javaab dadan be shoma aali hastand	موتورهای جستجو در جواب دادن به شما عالی هستند.
na agha hich chiz faghat yek rismaan peyda kardam ke kenar rishe drkht azad aftadh boud	نه اقا، هیچ چیز، فقط یک ریسمان پیدا کردم که کنار ریشه درخت ازاد افتاده بود
jdaa hal dkhtrmon aslaa khob nist khaanom aino babr doktor ta kar dstmon nadadeh	جداً حال دخترمون اصلاً خوب نیست. خانم اینو ببر دکتر تا کار دستمون نداده.
refigh in doost dokhtar mnh	رفیق این دوست دختر منه
dar hangam oaghah o bad az on che ehsasi be shoma dast dad	در هنگام واقعه و بعد از آن چه احساسی به شما دست داد؟
ghozk paye man khpl nist	!قوزک پای من خپل نیست
doostaan madrbzrgt chetoure	دوستان مادربزرگت چطور؟
na digar az an jasad khoon nmiamd fekr mikonam ke zkhm khoshk shodeh boud	نه دیگر از ان جسد خون نمیامد، فکر میکنم که زخم خشک شده بود.
o az hameh bishtar be srmaihgzarni ke baghieh shrktha ra mtghaad konand ta mesle adidas raftaar konand	و از همه بیشتر به سرمایهگذارنی که بقیه شرکتها را متقاعد کنند تا مثل آدیداس رفتار کنند
oonja boud ke fahmidam az daneshgah akhrajm kardan	اونجا بود که فهمیدم از دانشگاه اخراجم کردن
un behtarin barnameh hast	اون بهترین برنامه هست
bardaasht o mesle ye zan shod	برداشت و مثل یه زن شد
az mian in se laoitmn hanouz zendeh ast	از میان این سه، لاویتمن هنوز زنده است
choun un naghsh kheili khoubeh	چون اون نقش خیلی خوبه
lahze oghoa zlzlh dar yeki az froshgah hay shahr aslam abadghrb kermanshaah	لحظه وقوع زلزله در یکی از فروشگاه های شهر اسلام آبادغرب کرمانشاه
mashino gozashteh biroon aomdn kapotsho dzdidn faghat	ماشینو گذاشته بیرون اومدن کاپوتشو دزدیدن فقط
ya mashin chizish shodeh ke polis mi fhmh az jaaye barkhord moghaser kih	یا ماشین چیزیش شده که پلیس می فهمه از جای برخورد مقصر کیه
ba yek morabi o meghdari boodje yek ap jadid tarahi kardeand ke be jamahshan komak mikonad	با یک مربی و مقداری بودجه، یک اپ جدید طراحی کردند که به جامعهشان کمک میکند
khob deght kninmidanid chera adm nemishim	خوب دقت کنین،میدانید چرا ادم نمیشیم؟
aghamon hamishe tarifsh ro mi koneh ke kheili mard boudeh	اقامون همیشه تعریفش رو می کنه که خیلی مرد بوده
o kashef sarzamin hay doraftadh dar gorooh panjah o chahar	و کاشف سرزمین های دورافتاده در گروه پنجاه و چهار
aval az hameh jimzkomi dorost fhmidhbod	اول از همه، جیمزکومی درست فهمیدهبود
kami bozorgtar shood o agar khodesh khast o doost dasht be entekhaab khodesh barayash mikhrm	کمی بزرگتر شود و اگر خودش خواست و دوست داشت، به انتخاب خودش برایش میخرم
az bimaari nadari ranj mi board	از بیماری نادری رنج می برد.
bro vaase ghrar davatesh kon	برو واسه قرار دعوتش کن
amma akhrsh madrshohrm brgsht gftainm ba goftan man tanbalam khodsho rahat kardeh	اما آخرش مادرشوهرم برگشت گفت،اینم با گفتن من تنبلم خودشو راحت کرده
ta hala barayash tofang nkhridham	تا حالا برایش تفنگ نخریدهام
chera dari ou ra sosol baar miaavari	چرا داری او را سوسول بار میاوری؟
nazdik zohr dirooz boud	نزدیک ظهر دیروز بود؟
mard gftmhm nist emrouz sood kardam	مرد گفت:مهم نیست امروز سود کردم.
ma momkene ast ghasd ndashth bashim in ehsas ra be kasi bdhim amma vaghti in kar ra kardim aoaghbi darad	ما ممکن است قصد نداشته باشیم این احساس را به کسی بدهیم، اما وقتی این کار را کردیم، عواقبی دارد
vaghti az hghoght razi nisti	وقتی از حقوقت راضی نیستی
fekr mikoni taghsir khodshh	فکر میکنی تقصیر خودشه؟
mahram tarin fard zendegim mahsa st	محرم ترین فرد زندگیم مهسا ست
amma nemi donn ke oonja jaaye kheili khtrnakih	اما نمی دونن که اونجا، جای خیلی خطرناکیه
in mavared zang khtr ra baray man be seda draord choun hrfh man hemaayat az hghogh masraf konandegan ast	این مورد زنگ خطر را برای من به صدا درآورد، چون حرفه من حمایت از حقوق مصرف کنندگان است
hameh doost darim dar goshh bala samt rast bashim amn o jahani monaaseb baray ayande	همه دوست داریم در گوشه بالا سمت راست باشیم، امن و جهانی مناسب برای آینده
"danshgah hai ma ye rshtha ""nmkـ shnasi"" km darn "	"دانشگاه هاى ما یه رشتهء ""نمكـ شناسى"" كم دارن "
o aanhaayi ke dar madrese hastand ehsas mikonand ke maharathaie dorost ra nmiamoznd	و آنهایی که در مدرسه هستند احساس میکنند که مهارتهای درست را نمیآموزند
bayad eshtebah shmrdh basham	باید اشتباه شمرده باشم
pesarak ba shojaa'at khod ra amadh marg kardeh bodchon fekr mi karde ke ghrar ast tamam khoonash ra be khaharash bedahad	پسرک با شجاعت خود را اماده مرگ کرده بود،چون فکر می کرد که قرار است تمام خونش را به خواهرش بدهد!
aasabm un shab khoord boud	اعصابم اون شب خورد بود
hast ye chnd rouzi saei kardam kasi nfhmh ta ikhordh khodesh del o damaagh peyda koneh bad	هست یه چند روزی. سعی کردم کسی نفهمه تا یخورده خودش دل و دماغ پیدا کنه، بعد
azmayesh anjam midadh nsht kardeh ast	آزمایش انجام میداده، نشت کرده است
az didn man ta'ajob kardie	از دیدن من تعجب کردی ؟
ageh doo daghigheh ham bikar bashn ktabshono va mikonan o shorou be khoundan mikonan	اگه دو دقیقه هم بیکار باشن کتابشونو وا میکنن و شروع به خوندن میکنن
bad chnd daghigheh ba maman raftam biroon	بعد چند دقیقه با مامان رفتم بیرون
nahve tlfz namm ra biamozid	نحوه تلفظ نامم را بیاموزید
az oonja man dashtam	. از اونجا من داشتم
sbhonh rouz jmah bayad aintori basheh olaghir	صبحونه روز جمعه باید اینطوری باشه ولاغیر
aia be azadi aradh aghaeideh darid	ایا به ازادی اراده عقیده دارید؟
alaan mi tonh mesle yek parkor kar az rouye moana bprh o jabja besheh	الان می تونه مثل یک پارکور کار از روی موانع بپره و جابجا بشه
man fekr konam hanouz bironh	من فکر کنم هنوز بیرونه
ye vaght khob pish nayoomade	یه وقت خوب پیش نیومده
mi khum bezaram ye chizi bebini	می خوام بذارم یه چیزی ببینی
boudi azt zorgiri karde	بودی ازت زورگیری کرد ؟
tamam shab tou ataghm boudeh	.تمام شب تو اتاقم بوده
sdha milion ba astsmar robh ro hastand o soastfadh o khoshoonat	صدها میلیون با استثمار روبه رو هستند و سواستفاده و خشونت
oonja ro ba un atobosh mi tonam beram khuneh	اونجا رو، با اون اتوبوسه می تونم برم خونه
rosri an zan frou aftadh boud o chhrhash ra makhfi kardeh boud	روسری ان زن فرو افتاده بود و چهرهاش را مخفی کرده بود
o jaei nadaarim ke berim	.و جایی نداریم که بریم
hich kase tabhal tlashi baray tarkibe thlili ahdaafe tose'e paydar ba mrzhai siarhai nakardeh ast	هیچ کس تابحال تلاشی برای ترکیب تحلیلی اهداف توسعه پایدار با مرزهای سیارهای نکرده است
pas ma donbal rahhlhai pishrfth hastim rahhlhai jadid	پس ما دنبال راهحلهای پیشرفته هستیم راهحلهای جدید
amma ghodrat ba tkhil koudak shoma mmzoj nemishavad	اما قدرت با تخیل کودک شما ممزوج نمیشود
in iaro drough migeh shoma chera bavar mi knin tou ro khoda yeki manoo nejat bedeh	این یارو دروغ میگه شما چرا باور می کنین. تو رو خدا یکی منو نجات بده.
az yek paigah nezaami dar aamrikaa ke baray tolid salaah biolozhiki	از یک پایگاه نظامی در آمریکا که برای تولید سلاح بیولوژیکی
rah digari baray anjamsh hast	راه دیگری برای انجامش هست
blh hrki az ye chizi mi kshh yeki az donsth hash yeki az ndonsth hash	بله هرکی از یه چیزی می کشه یکی از دونسته هاش یکی از ندونسته هاش.
ye tikeh digeh az khashghchi ro peyda kardam	یه تیکه دیگه از خاشقچی رو پیدا کردم
oomad jelo goft khsth nabaashin	اومد جلو گفت خسته نباشین
shmam hmchin madrshohri daarin	شمام همچین مادرشوهری دارین؟
emrouz hich kari nakardam o faghat az atmsfr paiiz lezat bordam	امروز هیچ کاری نکردم و فقط از اتمسفر پاییز لذت بردم
ma mohit modbanhtri darim	ما محیط مودبانهتری داریم
davam inke noe shavahed mohem ast	دوم اینکه نوع شواهد مهم است
aina digeh mzahm be hesaab nmian	اینا دیگه مزاحم به حساب نمیان
chahardah emteyaz darim o ba tim sevom jadval faghat doamtiaz faseleh darim	چهارده امتیاز داریم و با تیم سوم جدول فقط دوامتیاز فاصله داریم
rahat bash chadrt ro dar biar amnh jan	راحت باش. چادرت رو در بیار امنه جان.
oh manam az un mikham	اوه منم از اون میخوام
pezeshk maaljozait bimaari minaa ra baray baraadar hfte salah ou tozih dad	پزشک معالج،وضعیت بیماری مینا را برای برادر هفت ساله او توضیح داد
amma shoma ghol dadin azash mraghbt knin	اما شما قول دادین ازش مراقبت کنین
unha hamdigeh ro darn	اونها همدیگه رو دارن.
amasbsh digeh ashti kardim o raft sarkaar	اماصبش دیگه آشتی کردیم و رفت سرکار
o dar nahhayat pnjm afzaishi shodid dar thsilato bhdasht bishtar	و در نهایت، پنجم، افزایشی شدید در تحصیلاتو بهداشت بیشتر
dar har hal ainkaro kardie	در هر حال اینکارو کردی
jalbh bdonid ke aksar ghatlin sــriali marof mtoldin aabaan mah hastand	جالبه بدونید که اکثر قاتلین ســریالی معروف ، متولدین آبان ماه هستند
choun aintori mi tonam	چون اینطوری می تونم
chizi ro mstsni mikoni	چیزی رو مستثنی میکنی؟
ma be donbal kar kardan bishtar dar zendegi hastim o hamchenaan kamtar o kamtar ehsas ghrabt mikonim	ما به دنبال کار کردن بیشتر در زندگی هستیم، و همچنان کمتر و کمتر احساس قرابت میکنیم
ageh bkshimsh mi tonim bebarimesh oonja	اگه بکشیمش، می تونیم ببریمش اونجا
basheh kheili khb , basheh	باشه ! خیلی خب , باشه
ta inja behtarin mogheeat perspolise taoiz khiabani boudeh	تا اینجا بهترین موقعیت پرسپولیس تعویض خیابانی بوده
man midounam ke hagh ba mnh	من میدونم که حق با منه
man pish danshgahi bodam	من پیش دانشگاهی بودم
jaaye khalit o chjori mitoonam baazam bebinam	جای خالیت و چجوری میتونم بازم ببینم؟
be nazaram in mojasame ra az rouye mraghbaie emtehaan dar iran bastan sakhtan	به نظرم این مجسمه رُ از روی مراقبایِ امتحان در ایران باستان ساختن
prsidnd che mi kony	پرسیدند : چه می کنی ؟
enekaas mosbat dehid o aatbar bebakhshid	انعکاس مثبت دهید و اعتبار ببخشید
dar bishtar mavaared aazaar o tbaiz yek tajrobe enzevaa o tnhaiiaor ast	در بیشتر موارد آزار و تبعیض یک تجربه انزوا و تنهاییآور است
inja in ro negah kon	اینجا، این رو نگاه کن
tasmimaat khodavand az ghodrat dark ma kharej ast amma hamishe be sood ma mi bashad	تصمیمات خداوند از قدرت درک ما خارج است اما همیشه به سود ما می باشد
rouzi paadeshah baray poost kandan mive kaarde tizi talab karde amma dar hine boridane mive angoshtash ra berid	روزی پادشاه برای پوست کندن میوه کارد تیزی طلب کرد اما در حین بریدن میوه انگشتش را برید
gzarshhai in kargrouh be dast vazir kharejeh reside o ou in gzarshhai ra be mikhaail gorbachof dad	گزارشهای این کارگروه به دست وزیر خارجه رسید و او این گزارشهای را به میخائیل گورباچوف داد
o biaiid anjamsh dahim	و بیایید انجامش دهیم
mi khoastm beram hazer shm	می خواستم برم حاضر شم
mrimdst o pnjh tou bayad tala gereft	مریم،دست و پنجه تو باید طلا گرفت
azizam manam doostat daram	عزیزم ، منم دوستت دارم
chenaanche ghsm yad karde ke man digar harfi nadaram	چنانچه قسم یاد کرد که من دیگر حرفی ندارم
chetoure dlton miad in har chi ham ke basheh baz ham ye moshh ye moush bdbkhto mflokh	چطور دلتون میاد؟ این هر چی هم که باشه باز هم یه موشه. یه موش بدبختو مفلوکه.
dast be delesh mi gird o be zamin mi aftd kaaram tmomh	دست به دلش می گیرد و به زمین می افتد کارم تمومه.
tamas shoma baray ma mohemeh	.تماس شما برای ما مهمه
khb chera behet drough begam	خب ، چرا بهت دروغ بگم
takhir ejtemaai takhir siasi takhir dar joamashan	تغییر اجتماعی، تغییر سیاسی تغییر در جوامعشان
un ba man be goor mirh	!اون با من به گور میره
toop hamash dast mrakshia boud	توپ همش دست مراکشیا بود
be raanande migi mi khoai brgrdi pish mamant	به راننده میگی می خوای برگردی پیش مامانت
srghimt be tfahm resiadan o kelide ro dad behemoon o	سرقیمت به تفاهم رسیدن و کلید رو داد بهمون و
khoahrm migeh jdida chghd tazgiha por harfe shdiamaaltshonmiprsh	خواهرم میگه جدیدا چقد تازگیها پر حرف شدی،اماعلتشونمیپرسه
shab bidari o bi khaabi azitt nknh	شب بیداری و بی خوابی اذیتت نکنه
asla moshkeli nist basheh	اصلا مشکلی نیست باشه ؟
man kmkton mi konam	من کمکتون می کنم
un tmizshon nakardeh boud	اون تمیزشون نکرده بود
ba yek mosaahebe bd mitavan joziyaate ra faramoush karde ya bd bekhaatere avarde	با یک مصاحبه بد میتوان جزییات را فراموش کرد یا بد بخاطر آورد
in dastan man brmigrdh be chnd sal pish	این داستان من برمیگرده به چند سال پیش
dalil asli in boud ke timhaii ke dar marz gstakhi hastand etelaat ra be rahati be ashtrak nmigzashtnd	دلیل اصلی این بود که تیمهایی که در معرض گستاخی هستند اطلاعات را به راحتی به اشتراک نمیگذاشتند
aya amalkard afrad oaghaa aasib mibinad man dar in mavared ham knjkao bodam	آیا عملکرد افراد واقعا آسیب میبیند؟ من در این مورد هم کنجکاو بودم
hich sooraakhi oonja nist	.هیچ سوراخی اونجا نیست
salam raychel geryan hastam	سلام . ریچل گرین هستم
bazi az ma momkene ast on ra gostaakhaane bdanim baghieh momkene ast on ra kamla modbanh bdannd	بعضی از ما ممکن است آن را گستاخانه بدانیم، بقیه ممکن است آن را کاملا مودبانه بدانند
afrad ebraze nashode ra be edameh sohbat faraa bkhoanid	افراد ابراز نشده را به ادامه صحبت فرا بخوانید
oala nemi donm un kheili adm mozih	والا نمی دونم، اون خیلی ادم موذیه
ke rafteh o manam srdmh	.که رفته و منم سردمه
khb bebakhshid baray in kar	خب ببخشید برای این کار
in gheyr ghaabel bavar hast	این غیر قابل باور هست
amidoarm baba movafagh besheh	امیدوارم بابا موفق بشه
goft chharm abtdaii bodam o rouzi az madrese baz gshtm dar hali ke medad siahm gom shodeh boud	گفت: چهارم ابتدایی بودم و روزی از مدرسه باز گشتم در حالی که مداد سیاهم گم شده بود
khob,chh charh ie dashtm-	خوب,چه چاره ای داشتم؟-
ageh man saaghdoosh tou bashm,	اگه من ساقدوش تو باشم,
htma ye kash ie zire nim kash ast	حتما یه کاسه ای زیر نیم کاسه است
ke mitavand ma ra be fazaye amliati amn beresand o ahdaafe amidoarknndh ejtemaai o eghtesaadi ra mohaghagh konad	که میتواند ما را به فضای عملیاتی امن برساند و اهداف امیدوارکننده اجتماعی و اقتصادی را محقق کند
agar ma pey bbrim ke dar hal mshahdh o nzart hastim ma raftaar khodemaan ra takhir khaahim dad	اگر ما پی ببریم که در حال مشاهده و نظارت هستیم، ما رفتار خودمان را تغییر خواهیم داد
ke hich vaght in ro ngin	که هیچ وقت این رو نگین
mageh nemi geh tou ataghh man raftam touye ashpzkhonh	مگه نمی گه تو اتاقه! من رفتم توی اشپزخونه.
asiaban gndm ou ra dar kenar saayer kise ha gozaashte ta be nobat ard konad	آسیابان گندم او را در کنار سایر کیسه ها گذاشت تا به نوبت آرد کند
ghaayem moshk bazha hastin	.قایم موشک بازها هستین
koja tashrif dashth baashin digeh	کجا، تشریف داشته باشین دیگه
drnhait akharin hlghh in paazel tkmilshdh	درنهایت آخرین حلقه این پازل تکمیلشده
yeki dareh migeh raft bala yeki migeh mikeshe payien yeki migeh aina bazishonh	یکی داره میگه رفت بالا، یکی میگه میکشه پایین، یکی میگه اینا بازیشونه
ye parandeh nadidan	یه پرنده ندیدن؟
zahmat mi sheh mi girm khoudam	زحمت می شه. می گیرم خودم.
khdaiish in dar shan final asia nist alaan digeh bayad zrshk plo ba morgh midadn	خداییش این در شأن فینال آسیا نیست الان دیگه باید زرشک پلو با مرغ میدادن
mibaram mi grdonmshjasho tamiz mi konam	میبرم می گردونمش،جاشو تمیز می کنم
vali dar in otagh bkhsos ehsas yek taze kar dar bayan nabghhhai tknolozhi ra dashtam	ولی در این اتاق بخصوص، احساس یک تازه کار در بین نابغههای تکنولوژی را داشتم
hmontor ke mi binin yekishoon kmh	همونطور که می بینین، یکیشون، کمه
chnd rouz bad paadeshah ba mlazmansh baray shekaar be nazdiki jngli rftnd	چند روز بعد پادشاه با ملازمانش برای شکار به نزدیکی جنگلی رفتند
mordeh shor in smak bbrh	مرده شور این سمعک ببره
ghol mi dahad an hayoolaa ra zendeh begirad o biavarad	قول می دهد ان هیولا را زنده بگیرد و بیاورد
ye modat ba khahar mohsen ham tlfni ashna shodeh bodam o ounam az rabeteh o alagheh ma khbar dasht	یه مدت با خواهر محسن هم تلفنی اشنا شده بودم و اونم از رابطه و علاقه ما خبر داشت
man nemi tonam gosht bokhoram	من نمی تونم گوشت بخورم
mardi dar namayeshgahi goldaan mi forookht	مردی در نمایشگاهی گلدان می فروخت
znha riz mi khndnd nejabat o shraft koja boud	زنها ریز می خندند نجابت و شرافت کجا بود؟
oabsthha mjozha o janshinanhai on gheyr ghaabel jobraane ke yani shoma nemi toanid nazar khod ra takhir dehid	وابستهها، مجوزها و جانشینانهای آن غیر قابل جبران که یعنی شما نمی توانید نظر خود را تغییر دهید
in be jzabit lig ezafeh mi konad o ma ham baray resiadan be rdh hay balatr tlash mi konim	این به جذابیت لیگ اضافه می کند و ما هم برای رسیدن به رده های بالاتر تلاش می کنیم
khoda shans bedeh ye shbh adma dara mi shn	خدا شانس بده یه شبه ادما دارا می شن!
migam bhtrh ye khordeh bkhoabi	میگم بهتره یه خورده بخوابی
misheh zip manoo bdi bala	میشه زیپ منو بدی بالا؟
rafti komak chera bdsh biad	رفتی کمک چرا بدش بیاد؟
baray ketab kharidan lebas kharidan pesaram masiha ranghaye mokhtalef lebas darad	برای کتاب خریدن، لباس خریدن پسرم مسیحا رنگهای مختلف لباس دارد
man pish danshgahi bodam	من پیش دانشگاهی بودم
man aghaye flahi hastam	من آقای فلاحی هستم
mkalmat zbt shodeh bache doostaan o khaanevaade baray ahdaafe tblighati mitavanest estefadeh shood	مکالمات ضبط شده بچه، دوستان و خانواده، برای اهداف تبلیغاتی میتوانست استفاده شود
paasokh dad dar in nazdiki chshmh abi hast o man moratab noke khod ra por az ab mi konam o an ra rouye atsh mi rizm	پاسخ داد : در این نزدیکی چشمه ابی هست و من مرتب نوک خود را پر از اب می کنم و ان را روی اتش می ریزم !
khodaya che donyaaye kochikih	خدایا چه دنیای کوچیکیه
kashfaii ke elaam mi konim	کاشفایی که اعلام می کنیم
ghrar gereftan drmian ghodrat hay jahan	قرار گرفتن درمیان قدرت های جهان
o dar zminh sanat mizbani etelaat anbashth daram	و در زمینه صنعت میزبانی اطلاعات انباشته دارم
azadh joun che khbar	ازاده جون چه خبر؟.
mitavanam ba javanan sohbat o molaaghaate konam o bshnomshan az hameh jaaye donya	میتوانم با جوانان صحبت و ملاقات کنم و بشنومشان از همه جای دنیا
amsal dar lig torkeyeh bazi mi konad	امسال در لیگ ترکیه بازی می کند
se dlarmon boro mi grdh	سه دلارمون بر می گرده؟
hishki nabayad az in dra vared inja besheh	هیشکی نباید از این درا وارد اینجا بشه
bayan doo nime sria sham khordim man ke asla nfhmidim chi mikhoram	بین دو نیمه سریع شام خوردیم من که اصلا نفهمیدیم چی میخورم
fhimh esfandiar kjast	فهیمه! اسفندیار کجاست ؟
baray sag ha mojoode mi bashad	برای سگ ها موجود می باشد
ke boro paaye oizhgihaii hmchon sen natoani o ghomit ast	که بر پایه ویژگیهایی همچون سن، ناتوانی، و قومیت است
vaght on rasideh ke az aazaar o tbaiz gozaaresh be aanhaayi bbrim ke mitavaanand in nabsamani ra dorost konand	وقت آن رسیده که از آزار و تبعیض گزارش به آنهایی ببریم که میتوانند این نابسامانی را درست کنند
ba cheshmaye koochik o bragh	با چشمای کوچیک و براق
kashef fough alaadh i srzminai davar aftadh	کاشف فوق العاده ی سرزمینای دور افتاده
oaz jadeh be davar aftadh ast	واز جاده به دور افتاده است.
aval dozdi hrfh ie	اول: دزدی حرفه ای
rast gofteh bekhodaa rghasn hmshon pdsga mkhsosn ageh dast o balshonm baz basheh	راست گفته بخدا رقاصن همشون پدسگا. مخصوصن اگه دست و بالشونم باز باشه.
anshaallh drmon koneh dard shmaro	انشاالله درمون کنه درد شمارو
o albate chalshha bghot khod baghi ast	و البته چالشها بقوت خود باقی است
sigar bekeshi mamnoo mikonam	سیگار بکشی ممنوع میکنم
ba iaohgoii oghtm ra tlf konam	با یاوهگویی وقتم را تلف کنم
az asaatid o slatin tghlid sedaye sag	از اساتید و سلاطین تقلید صدای سگ
amma alaave boro an rismaan shanhai niaz peyda kardam	اما علاوه بر ان ریسمان شانهای نیز پیدا کردم.
aanhaa feshar ziadi ehsas mikonand	آنها فشار زیادی احساس میکنند
hlh hooleh anglisi mzkhrf	حله حوله انگلیسی مزخرف
baray iadaori be jahan ke fnaori tanha zamani be nfa jame'e ast ke be ghavaanine asaasi ehteraam begzarad	برای یادآوری به جهان که فنآوری تنها زمانی به نفع جامعه است که به قوانین اساسی احترام بگذارد
dar roozegar ghdimpadshahi sang bozorgi ra dar yek jadeh i asli ghrar dad	در روزگار قدیم،پادشاهی سنگ بزرگی را در یک جاده ی اصلی قرار داد
khoon doid tou saram az asabaniat ro pa band naboodam	خون دوید تو سرم از عصبانیت رو پا بند نبودم
vali in hemaayat hich smri ndashth o airaniha az dashtane mashin arzan o khob bi bahre hastan	ولی این حمایت هیچ ثمری نداشته و ایرانیها از داشتن ماشین ارزان و خوب بی بهره هستن
o nezaakat dashtane tanha be in mana nist ke shoma yek aozi nistid	و نزاکت داشتن تنها به این معنا نیست که شما یک عوضی نیستید
amnh be parvane cheshm mi dozd	امنه به پروانه چشم می دوزد.
un ye tikeh talbi hast	اون یه تیکه طالبی هست
nemidoonam chikar konam	نمیدونم چیکار کنم
ke mitavand ma ra betor balghoh be aanjaa beresand	که میتواند ما را بطور بالقوه به آنجا برساند
ghashang malomh hmhshon ghol gereftan daneshgah ghabool shn dmaghshono amal knn	قشنگ معلومه همهشون قول گرفتن دانشگاه قبول شن دماغشونو عمل کنن!
az zamani ke thdidsh krdno lhsh kardan ta emrouz ke khb darid mi binid	از زمانی که تهدیدش کردنو لهش کردن تا امروز که خب دارید می بینید
shayad daastaanash ra dar chnd jomle kholase konad o man az shrsh khalaas shom	شاید داستانش را در چند جمله خلاصه کند و من از شرش خلاص شوم
baray inke ayande dstiabi be ahdaafe tose'e paydar daroon mrzhai siarhai ra knkash konim	برای اینکه آینده دستیابی به اهداف توسعه پایدار درون مرزهای سیارهای را کنکاش کنیم
shayad begid chera yek saa'at ro nmikhoabm ke bayad begam ya hameh ya hichks	شاید بگید چرا یک ساعت رو نمیخوابم که باید بگم یا همه یا هیچکس
pish be soi majrajoii	پیش به سوی ماجراجویی
kofth i tou ro doost darn	کوفته ی تو رو دوست دارن
ba abjoi mimon derakhshaane	با آبجوی میمون درخشان
az jaayegaahe bala raftam o dar moghaabele mkhatbin ghrar gereftam	از جایگاه بالا رفتم و در مقابل مخاطبین قرار گرفتم
poste ainstagrami jaaleb amirmahdi zholh drbarh rizeshe gheymate dolar	پست اینستاگرامی جالب امیرمهدی ژوله درباره ریزش قیمت دلار
ma motaghaed boudim ke parkhaashgari rouye amalkard o natije nahaei taasir migozaarad	ما معتقد بودیم که پرخاشگری روی عملکرد و نتیجه نهایی تاثیر میگذارد
mikham vali bad az zhrha	میخام ولی بعد از ظهرها
khb chi shod ke bosidish	خب چی شد که بوسیدیش ؟
chi begam oala az khoda ke pnhon nist az shoma che pnhonhdnbal ye dokhtar khobm brash	چی بگم والا از خدا که پنهون نیست از شما چه پنهونه،دنبال یه دختر خوبم براش.
va parvane jan tou nemi shnasi frshad manoo ye khaanom andaaz sho bgirh	وا پروانه جان تو نمی شناسی فرشاد منو؟ یه خانم انداز شو بگیره؟
akhh hia ham vaase admizad khob chizih	اخه حیا هم واسه ادمیزاد خوب چیزیه!
khb pas komak kon darash biarm	خب پس کمک کن درش بیارم
o bad aonaro btkonim	و بعد اونارو بتکونیم ؟
tou gorooh marg aftadim	تو گروه مرگ افتادیم
chizi ke msalh ra skhttr ham mikonad ankh aghlab tanha goah aanche boro ma rfthast khatrat ma hastand	چیزی که مساله را سختتر هم میکند آنکه، اغلب تنها گواه آنچه بر ما رفتهاست، خاطرات ما هستند
hameh sbhha ham nbodsh	.همه صبحها هم نبودش
maadh borhaani be onvan kaapitaane tim meli ke ghbla sabghh bazi dar sooperlige bolghaarestaan ra dasht	مائده برهانی به عنوان کاپیتان تیم ملی که قبلا سابقه بازی در سوپرلیگ بلغارستان را داشت
ba tbsmi goft sbbsh maadaram boud goftam chegouneh	با تبسمی گفت :سببش مادرم بود، گفتم چگونه؟
ahan in vaziat hadih	آهان ، این وضعیت حادیه
ashegh ke bashi ba kmtrin amkanat ham mitoni asheghet sabet kony	عاشق که باشی با کمترین امکانات هم میتونی عشقت ثابت کنی
mi tonam komak konam az ro eyvoonetoon rad beshin	می تونم کمک کنم از رو ایوونتون رد بشین
roikrdi boro asas ahdaafe o mhlthai az pish taiin shodeh	رویکردی بر اساس اهداف و مهلتهای از پیش تعیین شده
hichki ham nist baghalash konam	هیچکی هم نیست بغلش کنم
o dar toul na sal aanhaa be rkord behtarin amalkard dar tamam doran residand	و در طول نه سال آنها به رکورد بهترین عملکرد در تمام دوران رسیدند
chegouneh mitavanim shrktha ra mjab konim be dastresi be kherade jamat miansal	چگونه میتوانیم شرکتها را مجاب کنیم به دسترسی به خرد جماعت میانسال؟
tahvil bgirmaman jan az aolshm nemi khoastm biam	تحویل بگیرمامان جان از اولشم نمی خواستم بیام.
tou ye bkhshndh ie	تو یه بخشنده ای
man hameh jorh hoato daram	من همه جوره هواتو دارم
behtarin kari ke mitavanam bokonam in ast ke namrai bmanm	بهترین کاری که میتوانم بکنم این است که نامرئی بمانم
shayad vaghteshe rasideh ke aamdanhtr drbarho chgongi hamkaari jmai amal konim	شاید وقتش رسیده که عامدانهتر دربارهٔ چگونگی همکاری جمعی عمل کنیم
hooshe dijital nasl hzarh dar moghaabele hooshe hijani nasl aiks o nasl bad az jang davam	هوش دیجیتال نسل هزاره، در مقابل هوش هیجانی نسل ایکس و نسل بعد از جنگ دوم
brtri manoo lams krd	.برتری منو لمس كرد
" mohaghagh goft ""to mshklt chieh tou dir mirsi tou bimsaolit hsti"	" محقق گفت، ""تو مشکلت چیه؟ تو دیر میرسی، تو بیمسئولیت هستی"
ya in taamlat rozanhai ke ou ba karknansh dasht dar raahro dar ghzakhori ya dar jlsat	یا این تعاملات روزانهای که او با کارکنانش داشت، در راهرو، در غذاخوری یا در جلسات
titr zdh kodaam astan khaneh khalihai bishtari darad	تیتر زده کدام استان خانه خالیهای بیشتری دارد؟
chizi vaase tozih nmondh	چیزی واسه توضیح نمونده
vazir ke dar aanjaa boud goft negaran nabashid tamam chizhaii ke rokh midahad dar jahat kheir o slah shomast	وزیر که در آنجا بود گفت : نگران نباشید تمام چیزهایی که رخ میدهد در جهت خیر و صلاح شماست !
befarmaayid ghzaton meyl konid	بفرمایید غذاتون میل کنید
be raist ke oonja oastadh bego	به رئیست که اونجا واستاده بگو
touye grdhmaii ha mibinan	توی گردهمآیی ها میبینن
na shoma beshin man mi ram ke maamaanam nist bgirh janeb mo	نه شما بشین من می رم که مامانم نیست بگیره جانب مو.
tou asemoun monavar mizadan aksai yaadegaari migereftan	، تو آسمون منور میزدن، عکسای یادگاری میگرفتن
are hala ke be shoma reside droghh pas chera mal man rasth han javaab bedin	آره؟ حالا که به شما رسید دروغه؟ پس چرا مال من راسته؟ هان؟ جواب بدین؟
hala hameh mahal bayad ghfl bznn be khshtk shohrashon az tars tou	حالا همه محل باید قفل بزنن به خشتک شوهراشون از ترس تو.
mi toanstim bish az haftaad o shesh plh ham so'ood konim	می توانستیم بیش از هفتاد و شش پله هم صعود کنیم
bdahhkari bayan nasli dar mosighi o hnr shenaakhte shodeh ast	بداههکاری بین نسلی در موسیقی و هنر شناخته شده است
in kheili ghm angiz hast	این خیلی غم انگیز هست
are rghas lkhti dzdidsh	آره ، رقاص لختی دزدیدش
khb tou chikar mi kni	خب ، تو چیكار می كنی؟
ke ma ra boro eijad broniabiha ghadr sakhteh ta shbihsazihaii baray pishbini ayande bsazim	که ما را بر ایجاد برونیابیها قادر ساخته تا شبیهسازیهایی برای پیشبینی آینده بسازیم
o man hala tojhm ra matof kmkrsani bmrdm dar anjam zbt o gozaaresh aazaar o tbaiz dar mahal kar mikonam	و من حالا توجهم را معطوف کمکرسانی بمردم در انجام ضبط و گزارش آزار و تبعیض در محل کار میکنم
khob ejaze bedahid doostam kaaylaa ra moarefi konam	خوب اجازه بدهید دوستم کایلا را معرفی کنم
amma kaaylaa hamchenaan dar froshgahhai srasr jahan baray kharide orze shodeh ast	اما، کایلا همچنان در فروشگاههای سراسر جهان برای خرید عرضه شده است
tou kelaasemoon ye psrahl asfhan boud	تو کلاسمون یه پسراهل اصفهان بود
ba rghas lkhti khoabidi-	با رقاص لختی خوابیدی؟-
o hmsho madyoon sks hastim	و همشو مدیون سکس هستیم
yek tahghigh oaghaa ghavi dar in mavared az morgan make kal o maikl lombrado vojood darad	یک تحقیق واقعا قوی در این مورد از مورگان مک کال و مایکل لومبرادو وجود دارد
aahaay aghaye raeis are ba tou am	آهای، آقای رئیس آره، با تو ام
ye daghigheh pish sohbat kardie	یه دقیقه پیش صحبت کردی
ageh bayaane digeh baraatoon frsti nmimonh az rah posht baam akharin forsat shomast	اگه بیان دیگه براتون فرصتی نمیمونه .. از راه پشت بام، آخرین فرصت شماست.
tou khiaboun dari rah miri har doo nafari ke az kenaret rad mishn darn dar mavared dolar harfe mizanan	تو خیابون داری راه میری هر دو نفری که از کنارت رد میشن دارن در مورد دلار حرف میزنن
ye shohr darim mach kardan ro shmih bandi kardeh	یه شوهر داریم ماچ کردن رو سهمیه بندی کرده
ba khnde in ke hamash shod moush fekr kardam asmt dio se srh	با خنده این که همش شد موش. فکر کردم اسمت دیو سه سره.
dar ghesmat davam in reshte toiit be ou o emperaatoori rsanhai ke tasis karde bishtar khaahim pardakht	در قسمت دوم این رشته توییت، به او و امپراتوری رسانهای که تأسیس کرد، بیشتر خواهیم پرداخت
khodesh baraatoon ain iotob astrim mikone niazi nist sabr knin film danlod sheh	خودش براتون عین یوتوب استریم میکنه نیازی نیست صبر کنین فیلم دانلود شه
dar haghighat siarhai paydar pishniazi baray brkhordari bashar az rfah rouye zamin ast	در حقیقت، سیارهای پایدار پیشنیازی برای برخورداری بشر از رفاه روی زمین است
in be jzabit lig ezafeh mi konad o ma ham baray resiadan be rdh hay balatr tlash mi konim	این به جذابیت لیگ اضافه می کند و ما هم برای رسیدن به رده های بالاتر تلاش می کنیم
daghighan che vaght o drkdam tarikh rouye dad	دقیقاً چه وقت و درکدام تاریخ روی داد؟
an mard ngonbkht mirft	ان مرد نگونبخت میرفت
khnde o khoandn yek mozoo ast fhmidn mozoo digari ast	(خنده) و خواندن یک موضوع است، فهمیدن موضوع دیگری است
o ba in prozh ma hamchenin kari jadid anjam midhim	و با این پروزه ما همچنین کاری جدید انجام میدهیم
hichoght saei nakardam behesh lebas hayeh ba baar mfhomi jnsiti mesle abi bposhanm	هیچوقت سعی نکردم بهش لباسهای با بار مفهومی جنسیتی مثل ابی بپوشانم
hosele anjam karhaie zaroori rahm nadaarid	حوصله انجام کارهای ضروری راهم ندارید؟
sen man doo baraabare dojin mhnds dar on otagh boud	سن من دو برابر دوجین مهندس در آن اتاق بود
aknoon tavanaei ada kardan bdhkarish ra darad vali takhir mi andazd	اکنون توانایی ادا کردن بدهکاریش را دارد ولی تاخیر می اندازد
tou cheghadr saade ie kodoom mard o didi malh nkshn be trkmon	تو چقدر ساده ای؟ کدوم مرد و دیدی ماله نکشن به ترکمون؟
ounam na bekhaatere shoma bekhaatere un ghnari khaanom khng khoushgel behetoon forsat dadam	اونم نه بخاطر شما. بخاطر اون قناری خانم خنگ خوشگل بهتون فرصت دادم.
ki miad az khatrh raftanesh be paark shahr harfe bznh	کی میاد از خاطره رفتنش به پارک شهر حرف بزنه ؟
man un abar mi shnasm	من اون ابر می شناسم
o agar har kodaam az in noghat tamas ra be khoobi modiriat mikard baes mishd karkonan ehsas arzesh konand	و اگر هر کدام از این نقاط تماس را به خوبی مدیریت میکرد، باعث میشد کارکنان احساس ارزش کنند
baray man gheymate dolar mohem nist	برای من قیمت دلار مهم نیست
sevom takhir vaghei paradaim tose'e ast	سوم تغییر واقعی پارادایم توسعه است
mesle raychel tou dbirstanh	!مثل ریچل تو دبیرستانه
"""afsanh mard khtnh nshdh"" "	"""افسانه مرد ختنه نشده"" "
agar ghrar boud be arzesh ha o aghaid ehteraam gozaashte	اگر قرار بود به ارزش ها و عقاید احترام گذاشت
ta goftan jokhai znndh ta payam dadan dar hangam jalaseh	تا گفتن جوکهای زننده تا پیام دادن در هنگام جلسه
hengami ke maadaram fahmide skht mara tanbih karde o mara gheyr msol o bi havaas o	هنگامی که مادرم فهمید سخت مرا تنبیه کرد و مرا غیر مسول و بی حواس و
sinh ye zan ro lams karde	سینه یه زن رو لمس کرد؟
tasmimaat khodavand az ghodrat dark ma kharej ast amma hamishe be sood ma mi bashad	تصمیمات خداوند از قدرت درک ما خارج است اما همیشه به سود ما می باشد
aknoon in shoma ra ghadam bghdm dar dadan etelaa'aati ke mortabet bashad rhnmon mishod	اکنون این شما را قدم بقدم در دادن اطلاعاتی که مرتبط باشد رهنمون میشود
kamla mrbot be negah taraf moghaabele o inke ou ehsas bi ahtrami kardeh bashad bastegi darad	کاملا مربوط به نگاه طرف مقابل و اینکه او احساس بی احترامی کرده باشد بستگی دارد
asmonm ke mididi ye aalmh balon arzoha dasht ke kheili az zamin faseleh gerfte boudan o harekat mikrdn	اسمونم که میدیدی یه عالمه بالن ارزوها داشت که خیلی از زمین فاصله گرفته بودن و حرکت میکردن
moadab boudan vaghei yani karhaie kochki anjam dahim	مودب بودن واقعی یعنی کارهای کوچکی انجام دهیم
ba yeki az ham khaabgahi ham kheili samimi boudim	با یکی از هم خوابگاهی هام خیلی صمیمی بودیم
ma mitavanim in oiros ra hrjaii bbrim -- dar khaneh internet madrese o dar jame'e	ما میتوانیم این ویروس را هرجایی ببریم -- در خانه، اینترنت، مدرسه و در جامعه
raas baavaram nemisheh gofti	راس ، باورم نمیشه گفتی
amnh balakhrh tou in psrh ro didi yana	امنه بالاخره تو این پسره رو دیدی یانه؟
shayad dar jahan khanh-ashtraki aanghadr ahameiat ndashth bashad	شاید در جهان خانه-اشتراکی آنقدر اهمیت نداشته باشد
dar kodaam mogheeat makaani o koja etefagh oftade pas az rokhdad az on ba che kasi harfe zadid	در کدام موقعیت مکانی و کجا اتفاق افتاد؟ پس از رخداد از آن با چه کسی حرف زدید؟
kenar ye mimon bkhoabi	کنار یه میمون بخوابی ؟
goft az doostam medad gereftam be ou goftam khoubeh doostat az tou chizi nkhoast khoraaki chizi	گفت از دوستم مداد گرفتم به او گفتم: خوبه ، دوستت از تو چیزی نخواست؟ خوراکی چیزی
ye shohrdarim vaghti behesh goftam tloizion baraat mhmtrh bghlm krdo goft	یه شوهرداریم وقتی بهش گفتم تلویزیون برات مهمتره بغلم کردو گفت
sـkan hejdah drjh be samt jonoob bchrkhonid	سـکان هجده درجه به سمت جنوب بچرخونید
hala khoubeh maman touye joonish khodesh atish paare ie boudeh ha	حالا خوبه مامان توی جوونیش خودش اتیش پاره ای بوده ها.
sar damaagh biad bacheam htma barrooye cheshmam	سر دماغ بیاد بچم حتما بروی چشمم.
behetoon ghol midam hamin shjaa del ke khoudam basham tosh sot dmbsho begiram o partesh konam biroon	بهتون قول میدم همین شجاع دل که خودم باشم توسه سوت دمبشو بگیرم و پرتش کنم بیرون.
migeh nkbt ouna az haroard ansraf dadan na az payam navar	میگه نکبت اونا از هاروارد انصراف دادن نه از پیام نور
na agha moshkel ast ke adm onja daakhel shood digar asb jaaye khod ra darad	نه اقا، مشکل است که ادم انجا داخل شود دیگر اسب جای خود را دارد
ras az didanet khoshbakhtam	رآس ، از دیدنت خوشبختم
hmino mi khoastin shod idfah davar ham jma shim paye in mrda ro tou mjlsmon va nknin	همینو می خواستین؟ شد یدفعه دور هم جمع شیم پای این مردا رو تو مجلسمون وا نکنین
are fekr konam alaan delam	آره ، فکر کنم الان دلم
dorost mesle oobre eshteraaki	درست مثل اوبر اشتراکی
imaan majrajo hmknon vared mi shood	ایمان ماجراجو همکنون وارد می شود
azlat e bdnt ro shl kon	عضلات ِ بدنت رو شل کن
shoma chera nshsti inja hey tar tar mi khndi	شما چرا نشستی اینجا هی تر تر می خندی؟
khob iadgarihdkhtrh khoasth film jhazi ke babash koli hazine kardeh o behesh dadeh ro ngh dareh	خوب یادگاریه،دختره خواسته فیلم جهازی که باباش کلی هزینه کرده و بهش داده رو نگه داره
maman shoma khodet didi agha milad ro ke hameh ro jma kardie inja	مامان شما خودت دیدی اقا میلاد رو که همه رو جمع کردی اینجا؟
az taraf saidh hshrh eshgh	!از طرف سعیده. حشره عشق
man booye aaloo khoshk o znjbil mi shnom	من بوی آلو خشک و زنجبیل می شنوم
be hrhal kasaayi ke tou in veblaag hastan o dastan ha ro mikhoonan ghatan eshgh o tajrobe kardan	به هرحال کسایی که تو این وبلاگ هستن و داستان ها رو میخونن قطعا عشق و تجربه کردن
fardaa sobh az khaneh i mehr baznshstgan mian dnbalton	فردا صبح از خانه ی مهر بازنشستگان میان دنبالتون
azadh asla bro touye hmon otagh behesh bedeh	ازاده اصلا برو توی همون اتاق بهش بده.
hanouz chnd satri nnoshth bodam ke yeki az rofaghaaye zendan jlom sabz shod kenar takht neshast	هنوز چند سطری ننوشته بودم که، یکی از رفقای زندان جلوم سبز شد، کنار تخت نشست
o sadghanh begouim in ghzih man ra kheili ziad mitrsand	و صادقانه بگویم این قضیه من را خیلی زیاد میترساند
hamin alaan az oobre eshteraaki piadh shodam	همین الان از اوبر اشتراکی پیاده شدم
shayad khiliatonm shkstsho tajrobe krdin oaomdin inja ke ye joraii aroom beshin	شاید خیلیاتونم شکستشو تجربه کردین واومدین اینجا که یه جورایی اروم بشین
matghdh mach tou rouz faghat yek barbishtr az yek baar los bazih	معتقده ماچ تو روز فقط یک بار،بیشتر از یک بار لوس بازیه
anghd zibaast ke aadam doost dareh oonja baajenaaghe sho bkshh bad rahaa koneh brh	انقد زیباست که آدم دوست داره اونجا باجناق شو بکشه بعد رها کنه بره
shioh amal aanhaa salb kardan ast ya hedaayat poul be srmaihhai motamarkez dar atefi ast	شیوه عمل آنها سلب کردن است یا هدایت پول به سرمایههای متمرکز در عاطفی است
baazam mi kobmt be zamin	بازم می کوبمت به زمین
hanouz chnd satri nnoshth bodam khiki az rofaghaaye zendan jlom sabz shdknar takht neshast	هنوز چند سطری ننوشته بودم که،یکی از رفقای زندان جلوم سبز شد،کنار تخت نشست
nhzod zoud un parandeh doubareh mal ma misheh	نه،زود زود اون پرنده دوباره مال ما میشه
harchi ke hast saih bala srmh behtaere az toah ke shohr tou frari dadi ba douta bache tou damnt	هرچی که هست سایه بالا سرمه بهتر از توئه که شوهر تو فراری دادی با دوتا بچه تو دامنت
in proseh mesle yek oiros amal mikard	این پروسه مثل یک ویروس عمل میکرد
dashtam dar atash tbaiz jnsiti misokhtm	داشتم در آتش تبعیض جنسیتی میسوختم
chera bayad chiz bdi basheh	چرا باید چیز بدی باشه؟
yad gereftan az besiari az kshorhai dar hal tose'e ke kheili sria harekat krdhand	یاد گرفتن از بسیاری از کشورهای در حال توسعه که خیلی سریع حرکت کردهاند
kar nakardeh kheili daram chjori brsm be in kaaraa	کار نکرده خیلی دارم چجوری برسم به این کارا؟
vaghti migan bro mohandesi bkhon hnrm knarsh edameh midi	وقتی میگن برو مهندسی بخون هنرم کنارش ادامه میدی
fibz bshghabt ro bardar	فیبز ، بشقابت رو بردار
mi donm che kar mi karde	.می دونم چه کار می کرد
khdabh ou goft man didam ke ghom tou be ham rhm krdndmn chegouneh be in ghom rhm nknm	خدابه او گفت من دیدم که قوم تو به هم رحم کردندمن چگونه به این قوم رحم نکنم؟
in akhalghat bedeh ha ageh bkhad khodesh taarf mi koneh fekr konam khoshash niomd	این اخالقات بده ها. اگه بخاد خودش تعارف می کنه. فکر کنم خوشش نیومد.
zibaayaan nemitavaanand khod ra bposhanndzibaii navar ast o penhan nemimaanad	زیبایان نمیتوانند خود را بپوشانند.زیبایی نور است و پنهان نمیماند
khobhala be eftekhar tamam kashfai koochooloo	خوب،حالا به افتخار تمام کاشفای کوچولو
aya motmaen hastid ke aanhaa be nazar kheili toulani nistand	آیا مطمئن هستید که آنها به نظر خیلی طولانی نیستند
didam hmon pessar hastesh ye lahze tamam bdnm yakh shod	دیدم همون پسر هستش یه لحظه تمام بدنم یخ شد
sbha mi kshim ta laaghl hioona srhal bashn	صبحا می کشیم تا لااقل حیوونا سرحال باشن.
amma aya vaghean shoroot ra molaheze krdhaid	اما آیا واقعاً شروط را ملاحظه کردهاید؟
doo del baray raftan dast be shekamash mi znd fekr konam besheh falaa tahamolesh karde	دو دل برای رفتن، دست به شکمش می زند فکر کنم بشه فعلاً تحملش کرد.
setaare klassh shod btorikh hameh ou ra saheb mdadhai zkhirh mi shnakhtnd o hamishe az ou komak mi gereftand	ستاره کلاسش شد بطوریکه همه او را صاحب مدادهای ذخیره می شناختند و همیشه از او کمک می گرفتند
kaaylaa ghablit etesal be shbkh jahani o daaraaye tknolozhi tashkhise seda boud	کایلا قابلیت اتصال به شبکه جهانی و دارای تکنولوژی تشخیص صدا بود
doost dokhtaram be shookhi goft midouni asabaniat man baes shkstn astkhonat misheh	دوست دخترم به شوخی گفت میدونی عصبانیت من باعث شکستن استخونات میشه؟
man donbal ye ketab hastam	من دنبال یه کتاب هستم
ghodrat be shekl bisabghhai bsoi joanha sarazir mishod be dalil afzaayesh oabstgi ma be diQ hooshe dijital	قدرت، به شکل بیسابقهای بسوی جوانها سرازیر میشود به دلیل افزایش وابستگی ما به DQ : هوش دیجیتال
khoda azashoun ngzrh poost mondh o astkhon azshab shodeh bacheam	خدا ازشون نگذره پوست مونده و استخون ازش.اب شده بچم
o aanhaa ra toanmnd sakht ta daaraaye seda shavand	و آنها را توانمند ساخت تا دارای صدا شوند
parli kar jmaaori zaiaat plastiki az aghianos ra darad	پارلی کار جمعآوری ضایعات پلاستیکی از اقیانوس را دارد
riis pishin FBI dar otomobil khod minshst	رییس پیشین FBI در اتومبیل خود مینشست
ghalam ra rouye kaaghaz gzashtmmikhoastm be ou befahmaanam ke kar fori o foti daram	قلم را روی کاغذ گذاشتم،میخواستم به او بفهمانم که کار فوری و فوتی دارم
hamash ghabl az saa'at dah boud	همش قبل از ساعت ده بود
man joei hastam bazigrm	!من جویی هستم! بازیگرم
in rbat boston dainamiks har sari dareh trsnaktr misheh	این ربات بوستون داینامیکس هر سری داره ترسناکتر میشه
az hameh mohemtar movafagh be kashf raaz o moamaaye ghadimi khod shodam	از همه مهمتر موفق به کشف راز و معمای قدیمی خود شدم
chnd baar begam dozdi dar kar nist eshaare be mstrah moshkel az oonjast	چند بار بگم دزدی در کار نیست اشاره به مستراح مشکل از اونجاست.
salam raychel , khuneh ie	سلام ریچل , خونه ای ؟
gـlai azalia mo mi khorh	گـلای آزالیا مو می خوره
chndler kheili ba mohebate boud	چندلر خیلی با محبت بود
khrmgsi khod ra be an zkhm chsbanidh boud ke motavajeh amdn man nashod	خرمگسی خود را به ان زخم چسبانیده بود که متوجه امدن من نشد
aya behtaere nist sht asnad o ghablit hk zendeh kaaylaa ra ba ham brrsi konim ou injast	آیا بهتر نیست صحت اسناد و قابلیت هک زنده کایلا را با هم بررسی کنیم؟ او اینجاست
hengami ke shrktha hmpimani ra be afradshan amouzesh midahand brnamhhai jama o mtnoa ghoitr mishavand	هنگامی که شرکتها، همپیمانی را به افرادشان آموزش میدهند، برنامههای جامع و متنوع، قویتر میشوند
khob vaase moze ha bmon	.خوب واسه موزه ها بمون
ta bfhmim che klah bzrgi in jmhori aslami sar ma gozashteh o migzarh o vaghean dzdh	تا بفهمیم چه كلاه بزرگى این جمهورى اسلامى سر ما گذاشته و میگذاره و واقعاً دزده
bish az zaman film maratn yeki az filmhai hri patr ast o balaoh film pdrkhoandh	بیش از زمان فیلم ماراتن یکی از فیلمهای هری پاتر است و بعلاوه فیلم پدرخوانده
fekr mi kardam tou chndlri	.فکر می کردم تو چندلری
ke mitavand az tavanaei sisteme zamin baray mhiasazi rfah ejtemaai o eghtesaadi davar konad	که میتواند از توانایی سیستم زمین برای مهیاسازی رفاه اجتماعی و اقتصادی دور کند
dar msahbhai ba iori klochin yeki digar az jasosan kagab	در مصاحبهای با یوری کلوچین، یکی دیگر از جاسوسان کاگب
kholase on sal barayam tamrin amali dozdi hrfh ie boud	خلاصه آن سال برایم تمرین عملی دزدی حرفه ای بود
albrai un se ta mantosh ta kif o kafsh o rosri joda begiram	ال:برای اون سه تا مانتو،سه تا کیف و کفش و روسری جدا بگیرم
amra jan o beri ra bebinid ke dar cafe holz food ghahve bezanand	عمرا جان و بری را ببینید که در کافه هولز فود قهوه بزنند
aknoon tavanaei ada kardan bdhkarish ra darad vali takhir mi andazd	اکنون توانایی ادا کردن بدهکاریش را دارد ولی تاخیر می اندازد
o ageh ma in mashinaro nkhrim ki mikhad biad azashoun mashin bkhrh labod #bradr_zn_sdam	و اگه ما این ماشینارو نخریم كی میخواد بیاد ازشون ماشین بخره؟؟ لابد #برادر_زن_صدام
darand barnameh STEM ra thsil miknndalom tknolozhi mohandesi o riazi	دارند برنامه STEM را تحصیل میکنند:علوم، تکنولوژی، مهندسی و ریاضی
vaghti bazito mizarn tou fifa di vali bazham kambk mizni o mi beri	وقتی بازیتو میزارن تو فیفا دی ولی بازهم کامبک میزنی و می بری
ejaze bedahid be shoma neshan daham	اجازه بدهید به شما نشان دهم
vey afzood ba in vojood ghatar hamaanand saayer kshorhai gheyr ozv opek be ta'ahodaat in sazman paayband khahad maand	وی افزود: با این وجود قطر همانند سایر کشورهای غیر عضو اوپک به تعهدات این سازمان پایبند خواهد ماند
na ras tou jaei namiri	نه رآس ، تو جایی نمیری
khrmgsi khod ra be an zkhm chsbanidh boud ke motavajeh amdn man nashod	خرمگسی خود را به ان زخم چسبانیده بود که متوجه امدن من نشد.
yek maghaleh chapshdh dar shori edeaa mikonad oirosi ke baes aidz mishod	یک مقاله چاپشده در شوری ادعا میکند ویروسی که باعث ایدز میشود
chapgr ba ghodrat zom ta char baraabare	چاپگر، با قدرت زوم تا چعر برابر
be sarkaar raas negah konid	به سرکار راس نگاه کنید
tavanaei aanhaa dar estefadeh az kherade biantha o emaal kardanesh boro moshkelaat emroozi	توانایی آنها در استفاده از خرد بیانتها و اعمال کردنش بر مشکلات امروزی
az ghfshha toust sherkat amazon o oal-mart hzf shod	از قفسهها توسط شرکت آمازون و وال-مارت حذف شد
tloizion saa'at khrt o prtaton ba khodetoon bbrin	تلویزیون ساعت خرت و پرتاتون با خودتون ببرین
o blh in kar mstlzm astandardsazi dar nahve andazhgiri atefi az soi ma ast ke mashghoole on hastim	و بله، این کار مستلزم استانداردسازی در نحوه اندازهگیری عاطفی از سوی ما است، که مشغول آن هستیم
chndler tou bro posht miz	چندلر ، تو برو پشت میز
oh un ba nmkh fibz	اوه ، اون با نمکه فیبز
o kaaylaa dar hal hazer dar moze jasosi brlin ba aramesh dar hal astraht ast	و کایلا در حال حاضر در موزه جاسوسی برلین با آرامش در حال استراحت است
majra ro brash tarif kardam un gftmrim ageh midouni pessar khobih khb che ashkali dareh baahaash bishtar ashna bsho	ماجرا رو براش تعریف کردم اون گفت:مریم اگه میدونی پسر خوبیه خب چه اشکالی داره باهاش بیشتر اشنا بشو
man zire eyvoonetoon ghaayem shodam choun doosetoon daarami	من زیر ایوونتون قایم شدم چون دوستون دارمی
o chndler dareh miad khuneh	و چندلر داره میاد خونه
fibi joei ro doost dareh	فیبی جویی رو دوست داره
dar toul panj sal doog hameh chiz ra avaz karde	در طول پنج سال دوگ همه چیز را عوض کرد
khob in amr monjar be che shod kaaylaa dar keshvar aalmaan mamnoo shod	خوب این امر منجر به چه شد؟ کایلا در کشور آلمان ممنوع شد
baahaat ziad harfe mizaneh	باهات زیاد حرف میزنه
dar chart saazmaani kagab depaartemaane be naam depaartemaane A vojood dasht	در چارت سازمانی کاگب، دپارتمانی به نام دپارتمان A وجود داشت
shoharjan migoft chandtashoun ham azashoun koli kharide kardeh boudan	شوهرجان میگفت چندتاشون هم ازشون کلی خرید کرده بودن
naam shoma chist fin mirestad oh fin	نام شما چیست؟ فین میرستاد: اوه، فین
dorosteh dorosteh mi donestam	درسته درسته .می دونستم
emkan nadaare mageh momkeneh ba aghl o mantegh jor dar nemiad	امکان نداره؟ مگه ممکنه؟ با عقل و منطق جور در نمیاد.
masuliat che kesani ast booom in adamha	مسئولیت چه کسانی است؟ بوووم! این آدمها
agar harkas betavand az tarigh in vasael vared manzel shoma shood	اگر هرکس بتواند از طریق این وسایل وارد منزل شما شود
khob khanom ha o aghayan	خوب ، خانمها و آقایان
galoy pessar ra mi fesharad	گلوی پسر را می فشارد
in kheili shirine o hasaseh	این خیلی شیرین و حساسه
ghabl az inke parvaaz kony	قبل از اینکه پرواز کنی
vali ma fekr mikonim ke shodani ast	ولی ما فکر میکنیم که شدنی است
haman kargrouh kouchak niaz jedi gerfte nemishod	همان کارگروه کوچک نیز جدی گرفته نمیشد
ziba khanoum mi geh khabeh kojan baghieh	زیبا خانوم می گه خوابه کجان بقیه؟
bodo elias ye khordeh shokolaat behem bedeh	بدو الیاس، یه خورده شکلات بهم بده
hamchenin masraf konandegan nemitavaanand in kar ra khoudeshan anjam dahand	همچنین مصرف کنندگان نمیتوانند این کار را خودشان انجام دهند
lebas hayeh mardoone mi shore o aviz mi koneh ro band hamsham pirahan mardoone	لباسهای مردونه می شوره و اویز می کنه رو بند همشم پیراهن مردونه.
man kheili delvapasi boudmouli charhaye naboudnemitavanestim harfi bezanam	من خیلی دلواپس بودم،ولی چارهای نبود،نمیتوانستم حرفی بزنم
dorosteh khoobi ziad darhamkhab badihaie ham dareh	درسته خوبی زیاد داره،اماخب بدیهایی هم داره
bego ye hafteh darash ro baz gozashteh be rouye mardom	بگو یه هفته، درش رو باز گذاشته به روی مردم.
nemidoonam badehaa gharareh doubareh biad o baray hamishe bemoone yana	نمیدونم بعدها قراره دوباره بیاد و برای همیشه بمونه یانه
raas 10 ta saandevich gereft	راس 10 تا ساندویچ گرفت
ghaza napokhtan ya otagh avaz kardanat	غذا نپختن یا اتاق عوض کردنت؟
mi geh ghorob payiezeh beshinim tou hayat	می گه غروب پاییزه بشینیم تو حباط
mi khum bala tarin neshan eftekhar behet ehda konam	می خوام بالا ترین نشان افتخار بهت اهدا کنم
ye had o hodoodi bezaarim	یه حد و حدودی بذاریم
harkasi ba goushi hooshmand khod mitavand ba kaaylaa motasel gardad dar yek mahdodeh makaani	هرکسی با گوشی هوشمند خود میتواند با کایلا متصل گردد در یک محدوده مکانی
parkeh aalam jodaei dareh bara khodesh	پارکه عالم جدایی داره برا خودش
nashnidi sedaye esfandiar ro	نشنیدی صدای اسفندیار رو؟
are ezdevaj chizi badieh	آره ، ازدواج چیزی بدیه
o be javayezi manand behtarin makaan baray kar dast peyda kardeand	و به جوایزی مانند، بهترین مکان برای کار دست پیدا کردند
fekr mi kony orze in kar dari ha	فکر می کنی عرضه این کار داری، ها؟
sioyek saa'at chehelonoh daghigheh o yazdah sanieh zaman board	۳۱ ساعت، ۴۹ دقیقه و ۱۱ ثانیه زمان برد
ghabool mi konam nemi tonam	.قبول می کنم؟ نمی تونم
dar sal dohezaraosizdah man modir ejraaei yek moasese mohandesi beinolmelali bodam dar saanferaansisko	در سال ۲۰۱۳، من مدیر اجرایی یک موسسه مهندسی بینالمللی بودم در سانفرانسیسکو
ostansaraie tasirgozaari ejtemaai takhir raftaar	استانسرایی، تاثیرگذاری اجتماعی، تغییر رفتار
vali kasi delesh baray iran o irani nasookhte ke bekhaad az inkara bokoneh oonvaght digeh key dozdi koneh	، ولی کسی دلش برای ایران و ایرانى نسوخته كه بخواد از اینكارا بكنه، اونوقت دیگه كى دزدى كنه؟؟
vaase shast nafar ro rad konam	.واسه 60 نفر رو رد کنم
ma tahghighi baray farghe tahsilan madares kasb o kar ferestadim ke dar sazmanhaye motafaavet kar mikardand	ما تحقیقی برای فارغ التحصیلان مدارس کسب و کار فرستادیم که در سازمانهای متفاوت کار میکردند
barkhi koneshgarha chips doost darand amma ghatan poul mikhahand	برخی کنشگرها چیپس دوست دارند اما قطعا پول میخواهند
digaran azam miporsand chera tofang nadarad	دیگران ازم میپرسند چرا تفنگ ندارد؟
agar tavanmandieman baray tahaghogh ta'ahodaat ra si darsad afzaayesh dahim	اگر توانمندیمان برای تحقق تعهدات را سی درصد افزایش دهیم
azmayesh shishe zedgloleh dar sal 1930 milaadi 1309 khorshidi	آزمایش شیشه ضدگلوله در سال ۱۹۳۰ میلادی ۱۳۰۹ خورشیدی
baghi 85% az zaman o enerzhi serfe yek proseh besyar toulani be naam	باقی 85% از زمان و انرژی صرف یک پروسه بسیار طولانی به نام
amma ageh be ye fenjon ghahve ba shekarniaz dari	اما اگه به یه فنجون قهوه با شکرنیاز داری
dar hal hazer 1/8 milyard nafar javan bayan 10 ta 24 sal dar jahan vojood darand	در حال حاضر، ۱/۸ میلیارد نفر جوان بین ۱۰ تا ۲۴ سال در جهان وجود دارند
tedad nafarati besyar bishtar az tamam majmoeh vezarar kharejeh aamrikaa pas az hamle 11 septambr 2001	تعداد نفراتی بسیار بیشتر از تمام مجموعه وزارت خارجه آمریکا پس از حمله 11 سپتامبر 2001
dar chart saazmaani kagab depaartemaane be naam depaartemaane A vojood dasht	در چارت سازمانی کاگب، دپارتمانی به نام دپارتمان A وجود داشت
har rouz yek doo medad kesh mi rfttm taain ke ta payan term az tamami doustanam medad brdashth bodam	هر روز یک دو مداد کش می رفتتم تااین که تا پایان ترم از تمامی دوستانم مداد برداشته بودم
ke be tazif o khalgh napaidarihai zhaoplitk monjar mishod	که به تعضیف و خلق ناپایداریهای ژئوپلیتک منجر میشود
o migooyam jang ra board bjaii in ke poolash ra dar yek nobat begirad 20 baraabare mablaghe aolih ra pas gereft	و میگویم جنگ را برد، بجایی این که پولش را در یک نوبت بگیرد ۲۰ برابر مبلغ اولیه را پس گرفت
amma in gorooh az afsaraan kagab hanouz vojood dashtand o hkomt jadid rosih aanhaa ra hemaayat mikard	اما این گروه از افسران کاگب، هنوز وجود داشتند و حکومت جدید روسیه آنها را حمایت میکرد
yani 3brabr gheymate ik krolakh albate hichks in poul ro darjaa o naghd pardakht nmiknh	یعنی ٣برابر قیمت یك كرولا،كه البته هیچكس این پول رو درجا و نقد پرداخت نمیكنه
rouz sevom shorou kaaram dar yek astartap por shor dar silikan vali boud aoail sal dohezaraosizdah	روز سوم شروع کارم در یک استارتآپ پر شور در سیلیکان ولی بود اوایل سال ۲۰۱۳
msri ast o ba boudan atraf on ma niaz mobtala mishavim	مسری است، و با بودن اطراف آن ما نیز مبتلا میشویم
jal etelaat -tasirgzari boro o ya eijad afrad mosr boro afkaare omoomi ainfloansr	جعل اطلاعات -تأثیرگذاری بر، و یا ایجاد افراد مؤثر بر افکار عمومی (اینفلوئنسر)
yeki az in afsaraan javan ke dar 1975 be estekhdam kagab dramdh boud velaadimir pootin boud	یکی از این افسران جوان که در 1975 به استخدام کاگب درآمده بود ولادیمیر پوتین بود
chegouneh dar mshahdat tajrobeye ma ta sal 2015 boro asas sranh tolid nakhals meli rshd mikonand	چگونه در مشاهدات تجربی ما تا سال ۲۰۱۵ بر اساس سرانه تولید ناخالص ملی رشد میکنند
har ozv kagab movazaf boud 25% az zaman khod ra dar hrroz	هر عضو کاگب موظف بود 25% از زمان خود را در هرروز
saei karde yek keshti 107 mtri ra begirad dar halikh afsaraan niroi driaii ba tfnghai bozorg dar keshti boodand	سعی کرد یک کشتی ۱۰۷ متری را بگیرد در حالیکه افسران نیروی دریایی با تفنگهای بزرگ در کشتی بودند
ageh bkhai rghs foks trot ya tango tamrin kony	اگه بخای رقص فوکس تروت یا تانگو تمرین کنی
man tou rdiabi shekaar kaaram tkm	من تو ردیابی شکار کارم تکم
faramoush nakonid ke afsaraan kagab 25% az zaman khod ra serfe tolid etelaat ghlt mikardand	فراموش نکنید که افسران کاگب 25% از زمان خود را صرف تولید اطلاعات غلط میکردند
zira baray avalin baar dar toul tarikh ma ham zaman panj nslha ra dar adarat darim betor ghiramdi	زیرا برای اولین بار در طول تاریخ، ما هم زمان پنج نسلها را در ادارات داریم، بطور غیرعمدی
nahaa motaabegh mosaahebe shnakhti prssh mishod	نها مطابق مصاحبه شناختی پرسش میشود
khdahafz ordibehesht 97 baazam tekrar sho o tnham nzar	خداحافظ اردیبهشت ۹۷ ، بازم تکرار شو و تنهام نزار
be aanhaa ehsas arzesh ghadrdaani o mavared tavajoh boudan bedahid	به آنها احساس ارزش، قدردانی و مورد توجه بودن بدهید
ghabl az man 100 nafar digeh	قبل از من 100 نفر دیگه
pesarak pedarbozorgash ra tamaashaa karde ke namh ie mi nevesht	پسرک پدربزرگش را تماشا کرد که نامه ای می نوشت
inja ye polo tou brzilh ke 30 motor artfaa dareh	اینجا یه پل تو برزیله كه ٣٠ متر ارتفاع داره
soal sadhai ast o che bedaanid che nadaanid	سوال سادهای است، و چه بدانید چه ندانید
bikhial rich fahmidam digeh	بیخیال ریچ فهمیدم دیگه
in tajrobe ra dashtim	این تجربه را داشتیم
digeh hosele am ro sar aordin fekr mi kardam misheh bahaton maamlh karde	دیگه حوصله ام رو سر آوردین. فکر می کردم میشه باهاتون معامله کرد.
anfjar dar rbat karrim 4 oahd mskoni tkhrib o 9 nafar msdom shdand	انفجار در رباط کریم ۴ واحد مسکونی تخریب و ۹ نفر مصدوم شدند
az mah ramezan faghat 27 rouz mimonh	از ماه رمضان فقط 27 روز میمونه
yani mikham begam dashtane graish siasi tou in kshor az kar tou madnm skht trh	یعنی میخوام بگم داشتن گرایش سیاسی تو این كشور، از كار تو معدنم سخت تره
shmam hmchin madrshohri daarin	شمام همچین مادرشوهری دارین؟
nesf shrktknndgan listi daryaft kardeand ke 15 loghat baray shorou biadbi dasht	نصف شرکتکنندگان لیستی دریافت کردند که ۱۵ لغت برای شروع بیادبی داشت
bayad begouim gorooh angshtshmari az koneshgarha hast	باید بگویم گروه انگشتشماری از کنشگرها هست
chnd rouz bad paadeshah ba mlazmansh baray shekaar be nazdiki jngli rftnd	چند روز بعد پادشاه با ملازمانش برای شکار به نزدیکی جنگلی رفتند
gzarshhai in kargrouh be dast vazir kharejeh reside o ou in gzarshhai ra be mikhaail gorbachof dad	گزارشهای این کارگروه به دست وزیر خارجه رسید و او این گزارشهای را به میخائیل گورباچوف داد
az kode takhfif estefadeh kon	از کد تخفیف استفاده کن
avalin daahai sal nodo hfte	اولین دعاهای سال نودو هفت
man oaghan ta'ajob mikonam vaghti mishnavam dokhtary 2 milion khrej rang mohash kardeh	من واقعن تعجب میکنم وقتی میشنوم دختری 2 میلیون خرج رنگ موهاش کرده
tm ham mjbori ghabool kony	تم هم مجبوری قبول کنی
aya az tarigh modiriat be takhir dast zadand aya feshar vared kardeand	آیا از طریق مدیریت به تغییر دست زدند؟ آیا فشار وارد کردند؟
misham kashef ershad srzminai davar aftadh	میشم کاشف ارشد سرزمینای دور افتاده
sazmanhaii hmchon sazman ma ke baray hghogh msrfknndgan mobaareze mikonad	سازمانهایی همچون سازمان ما که برای حقوق مصرفکنندگان مبارزه میکند
javanan 25 darsad jmait hastand	جوانان ۲۵ درصد جمعیت هستند
baahaat ziad harfe mizaneh	باهات زیاد حرف میزنه
manzoor ma che farghi dasht	منظور ما چه فرقی داشت؟
dar chart saazmaani kagab depaartemaane be naam depaartemaane A vojood dasht	در چارت سازمانی کاگب، دپارتمانی به نام دپارتمان A وجود داشت
shoharjan migoft chandtashoun ham azashoun koli kharide kardeh boudan	شوهرجان میگفت چندتاشون هم ازشون کلی خرید کرده بودن
naam shoma chist fin mirestad oh fin	نام شما چیست؟ فین میرستاد: اوه، فین
dorosteh dorosteh mi donestam	درسته درسته .می دونستم
emkan nadaare mageh momkeneh ba aghl o mantegh jor dar nemiad	امکان نداره؟ مگه ممکنه؟ با عقل و منطق جور در نمیاد.
esme un iaro chi boud	اسم اون یارو چی بود ؟
» apl mashghoole kar kardan rouye on ast	» اپل مشغول کار کردن روی آن است
in kheili shirine o hasaseh	این خیلی شیرین و حساسه
ghabl az inke parvaaz kony	قبل از اینکه پرواز کنی
bayad mashin ro brgrdonm	باید ماشین رو برگردونم
vali ma fekr mikonim ke shodani ast	ولی ما فکر میکنیم که شدنی است
haman kargrouh kouchak niaz jedi gerfte nemishod	همان کارگروه کوچک نیز جدی گرفته نمیشد
matne khodkoshi vojood dashth	.متن خودکشی وجود داشته
ziba khanoum mi geh khabeh kojan baghieh	زیبا خانوم می گه خوابه کجان بقیه؟
giah shnasi ke mi khoad anoaa giaha ro be sourat fhrst namh dar biarh	گیاه شناسی که می خواد انواع گیاها رو به صورت فهرست نامه در بیاره
aina chikar mi knn	اینا چیکار می کنن؟
shhadt mard hizm shkni ke dar klantri azao bazprsi shodeh boud	شهادت مرد هیزم شکنی که در کلانتری ازاو بازپرسی شده بود
az on pessar porsid aya baray behboodi khaahart haazeri be un khoon ehda kony	از آن پسر پرسید: آیا برای بهبودی خواهرت حاضری به اون خون اهدا کنی؟
az akharin tlash hay sdasima baray jazab mkhatb	از آخرین تلاش های صداسیما برای جذب مخاطب
amma shoma khodetoon gftin	اما شما خودتون گفتین
mogheeat hay nakhosh ra be khoobi be mogheeat khob trbiti tabdil konim	موقعیت های ناخوش را به خوبی به موقعیت خوب تربیتی تبدیل کنیم
man ke mesle shoma azad nistam	من که مثل شما ازاد نیستم.
in oiros siasi pas az nofooz bharami doshmane khod ra az daroon naabood mikard	این ویروس سیاسی، پس از نفوذ، بهآرامی دشمن خود را از درون نابود میکرد
asla mail naboodam ba prhrfi oghtgzrani konam	اصلا مایل نبودم با پرحرفی وقتگذرانی کنم
bodo elias ye khordeh shokolaat behem bedeh	بدو الیاس، یه خورده شکلات بهم بده
hamchenin masraf konandegan nemitavaanand in kar ra khoudeshan anjam dahand	همچنین مصرف کنندگان نمیتوانند این کار را خودشان انجام دهند
ben avalin ghadam hasho dorost bardaasht	بن اولین قدم هاشو درست برداشت
hal adhai shayad astdlal konand ke tghiirat o arzshhai eijad shodeh az soi aanhaa zata kootaahe modat hastand	حال، عدهای شاید استدلال کنند که تغییرات و ارزشهای ایجاد شده از سوی آنها، ذاتا کوتاه مدت هستند
chap o nshr mghalat drough dar nshriat matbr	چاپ و نشر مقالات دروغ در نشریات معتبر
ye madrshohr daram doost dareh manoo hameh jabakhodsh bbrh o pz manoo bedeh	یه مادرشوهر دارم: دوست داره منو همه جاباخودش ببره و پز منو بده
raazi nabayad binshon basheh	رازی نباید بینشون باشه
ageh bkhai rghs foks trot ya tango tamrin kony	اگه بخای رقص فوکس تروت یا تانگو تمرین کنی
asla mail naboodam ba prhrfi oghtgzrani konam	اصلا مایل نبودم با پرحرفی وقتگذرانی کنم
tamam shab tou ataghm boudeh	.تمام شب تو اتاقم بوده
hala ke hameh sefaareshe dadan	حالا که همه سفارش دادن
mohemtar inke ghm o narahati hay paiiz gozashte ro ham paak karde	مهمتر اینکه غم و ناراحتی های پاییز گذشته رو هم پاک کرد.
manam bayad bargardam sar kar	منم باید برگردم سر کار
javanan az ma barnameh dars o thsil hamzaman mikhahand	جوانان از ما برنامه درس و تحصیل همزمان میخواهند
nime i aval tamoom shod	نیمه ی اول تموم شد
na man nistam khdahafz -	نه من نیستم خداحافظ -
tou ye mosaahebe digeh dari	تو یه مصاحبه دیگه داری
baray ketab kharidan lebas kharidan	برای کتاب خریدن، لباس خریدن
na be tou rftnt na be in biroon aomdnt	نه به تو رفتنت. نه به این بیرون اومدنت.
mesle adidas adidas aghianos ra tamiz mikonad o dar in fraind poul dar miaord	مثل آدیداس: آدیداس اقیانوس را تمیز میکند و در این فرایند پول در میآورد
aasf rafteh shayad elias nfhmh	عاصف رفته شاید الیاس نفهمه
oh behtaere az in nemishod	اوه بهتر از این نمیشد
hmoni ke behesh chp chp negah mi kardie un saham mnh gofteh basham	همونی که بهش چپ چپ نگاه می کردی. اون سهم منه. گفته باشم.
doktor oinbrg ghol dadidn	دکتر وینبرگ قول دادیدن
jdidtrin model lebas monaaseb baray madrbzrga kalkshn zemestan	جدیدترین مدل لباس مناسب برای مادربزرگا، کالکشن زمستان
hich fekr nemikardam ke vey be chenin srnoshti dchar mishod	هیچ فکر نمیکردم که وی به چنین سرنوشتی دچار میشود
aanhaa ra boland boland khoandim jrian azmayesh be sourat zendeh dar sait ma	آنها را بلند بلند خواندیم، جریان آزمایش به صورت زنده در سایت ما
bia doubareh emtehaan konim	بیا دوباره امتحان کنیم
shaar bachegi ma in boud ke dkhtrha moshand o psrha shirnd	شعار بچگی ما این بود که دخترها موشاند و پسرها شیرند
mah rmzon tamoom shod o emrouz eyd ftrh	ماه رمضون تموم شد و امروز عید فطره
masuliat che kesani ast booom in adamha	مسئولیت چه کسانی است؟ بوووم! این آدمها
in iaro drough migeh shoma chera bavar mi knin tou ro khoda yeki manoo nejat bedeh	این یارو دروغ میگه شما چرا باور می کنین. تو رو خدا یکی منو نجات بده.
yek mard roostaayi ba baar sbzijat be nazdik sang reside	یک مرد روستایی با بار سبزیجات به نزدیک سنگ رسید
mardom jigh mizadan	مردم جیغ میزدن
agar harkas betavand az tarigh in vasael vared manzel shoma shood	اگر هرکس بتواند از طریق این وسایل وارد منزل شما شود
madrbzrg hshtad o hfte salham rouzi dah baar migeh razim be rzai khoda o amadhi marg	مادربزرگ هشتاد و هفت سالهام روزی ده بار میگه راضیم به رضای خدا و امادهی مرگ
baray ye modat kheili toulani	برای یه مدت خیلی طولانی
javanan hamchenin migouyand ke mikhahand saayer javanan ra komak konand	جوانان همچنین میگویند که میخواهند سایر جوانان را کمک کنند
hti jana partnrz haman gnsgtrhai asile ke jan aanhaa ra hramzadhhai tmaa minamd	حتی جانا پارتنرز، همان گنسگترهای اصیل که جان آنها را حرامزادههای طماع مینامد
na agha hich chiz faghat yek rismaan peyda kardam ke kenar rishe drkht azad aftadh boud	نه اقا، هیچ چیز، فقط یک ریسمان پیدا کردم که کنار ریشه درخت ازاد افتاده بود
tou ke asla aono nkhondi	تو که اصلا اونو نخوندی
man bache ke bodam ashegh gol bodam	من بچه که بودم عاشق گل بودم
velash kon kshtish hala ghltih ke kardeh	ولش کن. کشتیش. حالا غلطیه که کرده.
barkhi az bzrgan srotmnd ba kaaleske hay khod be kenar sang residand	برخی از بزرگان ثروتمند با کالسکه های خود به کنار سنگ رسیدند.
aknoon tavanaei ada kardan bdhkarish ra darad vali takhir mi andazd	اکنون توانایی ادا کردن بدهکاریش را دارد ولی تاخیر می اندازد
tou brfa draz keshidam	تو برفا دراز کشیدم
vaase tou o amili emshab	.واسه تو و امیلی. امشب
chetoure ejaze midi doroztmam ye moush ke aslaa maloom nist nrh ya maaede biad touye khuneh	چطور اجازه میدی دوروزتمام یه موش که اصلاً معلوم نیست نره یا ماده بیاد توی خونه؟
gorooh mozik mshhorh	گروه موزیک مشهوره؟
hamash doost daram harfe bznmhrf donm kheili por shodeh	همش دوست دارم حرف بزنم،حرف دونم خیلی پر شده
khob khanom ha o aghayan	خوب ، خانمها و آقایان
nemitoonim ba ham bashim	.نمیتونیم با هم باشیم
khob inam ghahve khonst	.خوب ، اینم قهوه خونست
khodmm mondm che jouri mitoonam zendeh bemoonam	خودمم موندم چه جوری میتونم زنده بمونم
nemi tonam in karo bokonam	نمی تونم این کارو بکنم
in maarfh man dar aanjaa boud	این معارفه من در آنجا بود
hich lbasi peyda nemikonim	هیچ لباسی پیدا نمیکنیم
marj ye doost dokhtar dareh	مارج یه دوست دختر داره
digeh nemisheh baahaat tou yek otagh o zire yek saghf zendegi karde	دیگه نمیشه باهات تو یک اتاق و زیر یک سقف زندگی کرد
amma dar vaaghe modiriat ra oadar be eijad tghiirati nemikonand ke mohit zist o ajtmaa ra takhir khahad dad	اما در واقع مدیریت را وادار به ایجاد تغییراتی نمیکنند که محیط زیست و اجتماع را تغییر خواهد داد
kasb o kari ke arzesh on dar hodoude se milion dolar dar sal ast	کسب و کاری که ارزش آن در حدود سه میلیون دلار در سال است
ma vasael kaafi niaordim	ما وسایل کافی نیاوردیم
brai hrdstgah khodroi oardati	براى هردستگاه خودروى وارداتى
ou ghlh i everest ra davar mi znd	او قله ی اورست را دور می زند
tou yeki az daneshgah hay tehran ghabool shodam	تو یکی از دانشگاه های تهران قبول شدم
o dokhtaran be man migouyand	و دختران به من میگویند
sepas yek nafar digar ra jelo miandakhtnd ta az hrfhaishan dfaa konad	سپس یک نفر دیگر را جلو میانداختند تا از حرفهایشان دفاع کند
man ashegh monikai mstm	من عاشق مونیکای مستم
paap koja zendegi mi knh-	پاپ کجا زندگی می کنه؟-
nazdik digeh che mzkhrfih	نزدیک دیگه چه مزخرفیه
o taghsir raychel ham nistsh	.و تقصیر ریچل هم نیستش
dari kheili skhtsh mi kony	!داری خیلی سختش می کنی
na mikham zobesh knm-	.نه ، میخام ذوبش کنم-
bezaar ye baar ghablesh bokonam	.بزار یه بار قبلش بکنم
az kheili hashnidm ke migan	از خیلی هاشنیدم که میگن
man ham az didanet khoshhaalam	من هم از دیدنت خوشحالم
jaiikh shkhsa ahameiat midahid amma mostaghim be chalesh ham mikeshid	جاییکه شخصا اهمیت میدهید، اما مستقیم به چالش هم میکشید
amrikaii vaghti ba aadam harfe mizaneh ke oaghaa kari dashth basheh	آمریکایی وقتی با آدم حرف میزنه که واقعا کاری داشته باشه
mi donm chi fekr mi kony	.می دونم چی فکر می کنی
o zan hay bd az zan hay khob mshkhsh	و زن های بد از زن های خوب مشخصه
haminjoori oonja nshinin manoo negah knin	همینجوری اونجا نشینین منو نگاه کنین
tou boudi ke tmomsh kardie	تو بودی که تمومش کردی
bara inke sbor nbodi	برا اینکه صبور نبودی ؟
behesh bego man hasasiat daram	بهش بگو من حساسیت دارم
in khuneh mard dareh sarvar dareh	این خونه مرد داره. سرور داره.
ta tghiirat baray behbood mohit zist o ajtmaa emaal shood	تا تغییرات برای بهبود محیط زیست و اجتماع اعمال شود
ta hala savaar ye khuneh i parandeh nashode bodam	تا حالا سوار یه خونه ی پرنده نشده بودم
o edameh dasht ta afsaraan niroi driaii aslhh kshidnd o amliat be payan reside	و ادامه داشت تا افسران نیروی دریایی اسلحه کشیدند و عملیات به پایان رسید
man bayad baahaat harfe bezanam	من باید باهات حرف بزنم
tou in ja chi kar mikoni	تو این جا چی کار میکنی؟
kar ma be onvan hampeymaan in ast ke rizkhoshounatha ra beshnasim o anjameshan nadehim	کار ما به عنوان همپیمان این است که ریزخشونتها را بشناسیم و انجامشان ندهیم
sedaye kherade shodan nan khoshk be goush mi rsd	صدای خرد شدن نان خشک به گوش می رسد
man o shoma mitavanim baray hamdigar hampeymaan shavim che dar mohit kar bashim che biroon	من و شما میتوانیم برای همدیگر همپیمان شویم، چه در محیط کار باشیم چه بیرون
khnde faghat raftan tou bzrgrah o gsht zadan	(خنده) فقط، رفتن تو بزرگراه و گشت زدن
un tou raftan cheghadr mitoone zajr aavare basheh	اون تو رفتن چقدر میتونه زجر آور باشه.
in masire ra be ma midahad	این مسیر را به ما میدهد
gerfte boud baraam biari	گرفته بود برام بیاری ؟
oh khodaye man moonika	!اوه ، خدای من! مونیکا
kari krd ke hoadarai baghieh i tim ha betoonan final asia ro az nzdik bebinan	كارى كرد كه هواداراى بقیه ى تیم ها بتونن فینال آسیا رو از نزدیك ببینن
ghaza kooshesh man ghzamo mi khum	غذا کوشش؟ من غذامو می خوام
behet bgn ashghali khoubeh	!بهت بگن آشغالی ، خوبه
bayad beram aamaade besham	باید برم آماده بشم
yek mard roostaayi ba baar sbzijat be nazdik sang reside	یک مرد روستایی با بار سبزیجات به نزدیک سنگ رسید
bebin ghzih az in gharareh	ببین قضیه از این قراره
dar edameh brrsi mikonim ke dar posht pardeh in etefagh che boudeh ast	در ادامه بررسی میکنیم که در پشت پرده این اتفاق چه بوده است
hasan ghsh nakhour darim miaim	حسن غصه نخور داریم میایم
se sal maande be payan mhlt	سه سال مانده به پایان مهلت
bayad sria poul jma konam	.باید سریع پول جمع کنم
anglisi harfe nmiznh	انگلیسی حرف نمیزنه
taasir medad siah dar zendegi doo koudak	تاثیر مداد سیاه در زندگی دو کودک
man ozrkhaahi lazem daram	.من عذرخواهی لازم دارم
kam kam adat kardam be faza o vaghti be khoudam umadam didam ikmah az daneshgah gozashte	کم کم عادت کردم به فضا و وقتی به خودم اومدم دیدم یکماه از دانشگاه گذشته
ma hmchin kari nemi konim	ما همچین کاری نمی کنیم
didn tou kheili aali boud	دیدن تو خیلی عالی بود
vaghti ou ra bazdasht kardam rouye polo az asb be zamin aftadh o minalid	وقتی او را بازداشت کردم روی پل از اسب به زمین افتاده و مینالید
ke mitavaanand tamam ahdaafe tose'e paydar ra naabood konand	که میتوانند تمام اهداف توسعه پایدار را نابود کنند
vaase hamin donbaalash gshtm	.واسه همین دنبالش گشتم
arros nmonhmn arros shodam ke shohrdari knmaros faghat ye vazife darhzn khoobi baray shooharash basheh	عروس نمونه:من عروس شدم که شوهرداری کنم،عروس فقط یه وظیفه داره،زن خوبی برای شوهرش باشه
faghat be meghdaar kami az javanan miresad	فقط به مقدار کمی از جوانان میرسد
msiri shgftangiz bsoi fazaye amliati amn rouye zamin hasl shodeh ast	مسیری شگفتانگیز بسوی فضای عملیاتی امن روی زمین حاصل شده است
in sedaye shoma boud ke srmaihdarha ra dar ohlh aval baojdantr karde	این صدای شما بود که سرمایهدارها را در وهله اول باوجدانتر کرد
asln bfrmaiin khuneh ma	اصلن بفرمایین خونه ما.
be abart digar mitavanim jahani amn o be manai kalame jahan bsazim	به عبارت دیگر، میتوانیم جهانی امن و به معنای کلمه جهان بسازیم
ma mohit modbanhtri darim	ما محیط مودبانهتری داریم
sedaye friadha o zarbeh hay dar az biroon bishtar o bishtar mi shood	صدای فریادها و ضربه های در از بیرون بیشتر و بیشتر می شود
tasavor konid ke che jahan sbztr o behtary khahad shod	تصور کنید که چه جهان سبزتر و بهتری خواهد شد
daaknid aindfah digeh moshkeli pish niad	دعاکنید ایندفعه دیگه مشکلی پیش نیاد
be khater in msalh nist	به خاطر این مسئله نیست
sedaye zarbeh hay mohkam be dar khaneh be goush miresad	صدای ضربه های محکم به در خانه به گوش میرسد
jouri ke bazi az dkhtra rzh lb mizanan ta lbshon bozorgtar be nazar biad	جوری که بعضی از دخترا رژ لب میزنن تا لبشون بزرگتر به نظر بیاد
o barkhi az akhbar khob niaz vojood darad	و برخی از اخبار خوب نیز وجود دارد
salam bebakhshid dir kardam	سلام ، ببخشید دیر کردم
yani jedi ghabool mi kony	یعنی جدی قبول می کنی ؟
por az enerzhi mosbat boud	پر از انرژی مثبت بود
ta ghabl inke hameh chiz kharab besheh bhtrh ye fekr aaghelaane bokonim	تا قبل اینکه همه چیز خراب بشه بهتره یه فکر عاقلانه بکنیم.
galoy pessar ra mi fesharad	گلوی پسر را می فشارد
bhosilh on alayhe aalmaan ghrbi bohraan siasi eijad karde	بهوسیله آن علیه آلمان غربی بحران سیاسی ایجاد کرد
imaan majrajo hmknon vared mi shood	ایمان ماجراجو همکنون وارد می شود
man digeh daram asabi misham	من دیگه دارم عصبی میشم
are sara har chi basheh	.آره سارا ، هر چی باشه
behem ye forsat bedeh ta-	.بهم یه فرصت بده تا-
vaziat javan iraani o mdirsh sar kar	وضعیت جوان ایرانی و مدیرش سر کار
sobh ham ba maman o baba raftim biroon	صبح هم با مامان و بابا رفتیم بیرون
dar baraabare aazaar o tbaiz mohit kar	در برابر آزار و تبعیض محیط کار
har manai frsti ast ta ozaitman ra behbood bkhshim	هر مانعی ، فرصتی است تا وضعیتمان را بهبود بخشیم
khosh oomadi madar bia tou	خوش اومدی مادر. بیا تو.
gofteh dnbalh baznshstgimm	گفته دنباله بازنشستگیمم!
mamnoon mzahm toon shodim	ممنون. مزاحم تون شدیم.
yani dar toul anjam mamoritshan kamlaa dar knarshan bashid	یعنی، در طول انجام ماموریتشان کاملاً در کنارشان باشید
khdabh karshon rongh bedeh	خدابه کارشون رونق بده
dolat faghat ba dramd doo se salsh az mahal varedat khodro	دولت فقط با درآمد دو سه سالش از محل واردات خودرو
vali alaan raftam tou ashpzkhonh didam babam shamsho nakhorde	ولی الان رفتم تو اشپزخونه دیدم بابام شامشو نخورده
dishab az tou khoshshon oomad	دیشب از تو خوششون اومد
msla znhai bd hjab ro ba halthai mokhtalef mizarn ta oaknshhai admharo bebinan	مثلا زنهای بد حجاب رو با حالتهای مختلف میذارن تا واکنشهای آدمهارو ببینن
oh are man ham hamin toor	اوه آره من هم همین طور
drsorti ke khb khaanevaade mnkhodmndostamkli daakrdn o koli nzramahichoght nagoftan makrdim	درصورتی که خب خانواده من،خودمن،دوستام،کلی دعاکردن و کلی نذر،اماهیچوقت نگفتن ماکردیم
in avalin ghadam baray takhir khoudam	این اولین قدم برای تغییر خودم
mrdashon kheili cheshm pakn choun brashon aadi shodeh az bs ke didn	مرداشون خیلی چشم پاکن چون براشون عادی شده از بس که دیدن
- man daram harfe mi znm	- من دارم حرف می زنم
fateme sotoode atfagha in mozoo baray khoudam ham jaaleb boud	فاطمه ستوده: اتفاقا این موضوع برای خودم هم جالب بود
hameh az ghzih bakhbr mishn	همه از قضیه باخبر میشن
man hich vaght be kasi drough nagoftam	من هیچ وقت به کسی دروغ نگفتم
amidoarm baba movafagh besheh	امیدوارم بابا موفق بشه
zan gheymate gldanha ra porsid	زن قیمت گلدانها را پرسید
elias az oonja bia biroon	الیاس، از اونجا بیا بیرون
alaan tou amrika hameh nshstn paye saitha o kanalhai srafiha darn gron shodan rial ro negah mikonan	الان تو امریکا همه نشستن پای سایتها و کانالهای صرافیها دارن گرون شدن ریال رو نگاه میکنن
albate ke lili ro iadmh	البته که لیلی رو یادمه
azash khoasth bodam	ازش خواسته بودم
man kheili behetoon alagheh daram	من خیلی بهتون علاقه دارم.
ageh ghrar nist un chizi ro ke mikham behem bdi	اگه قرار نیست اون چیزی رو که میخوام بهم بدی،
in kheili ohshianh hast	این خیلی وحشیانه هست.
ageh in ghzih dorost basheh	اگه این قضیه درست باشه
un ba nik nemi khoabid	اون با نیک نمی خوابید
be hrhal kasaayi ke tou in veblaag hastan o dastan ha ro mikhoonan ghatan eshgh o tajrobe kardan	به هرحال کسایی که تو این وبلاگ هستن و داستان ها رو میخونن قطعا عشق و تجربه کردن
amma an hangam ke khodavand mi prsd zamani ke doostat dar atsh mi sokht tou che kardie	اما ان هنگام که خداوند می پرسد : زمانی که دوستت در اتش می سوخت تو چه کردی؟
ehsas miknm pirmrdh tou zendegi ghblish kntrl tloizion boudeh	احساس میكنم پیرمرده تو زندگی قبلیش كنترل تلویزیون بوده
ye shohr darim mach kardan ro shmih bandi kardeh	یه شوهر داریم ماچ کردن رو سهمیه بندی کرده
doubareh behet zang mi znm	.دوباره بهت زنگ می زنم
bazi dostanh i mfidi ro ba kshorai digeh bargozaar kardim	بازی دوستانه ی مفیدی رو با کشورای دیگه برگزار کردیم
naghsham in boud ke dar manzar aam karamozi konam o dar khafa morabbigari	نقشم این بود که در منظر عام کارآموزی کنم و در خفا مربیگری
fekr mi konam betunam befahmam	فکر می کنم بتونم بفهمم
faghat inghadr tarsnaak naboud	فقط اینقدر ترسناک نبود
vaghti migan maahi ndh dastesh behesh mahigiri yad bedeh	وقتی میگن ماهی نده دستش، بهش ماهیگیری یاد بده
tou be tamrin niaz dari	تو به تمرین نیاز داری
hamchenin shghlhaii ke hanouz abdaa nshdhand	همچنین شغلهایی که هنوز ابداع نشدهاند
nmikhoai bebini tosh chieh	نمیخوای ببینی توش چیه؟
doost daarin hamishe dast zoor ro srton basheh	دوست دارین همیشه دست زور رو سرتون باشه؟
hala meli pooshan dokhtar valibal iran dar mian chehel tim bartar jahan hastand	حالا ملی پوشان دختر والیبال ایران در میان چهل تیم برتر جهان هستند
srdrgm bodam amidm az hameh ja ghta shodeh boud	سردرگم بودم، امیدم از همه جا قطع شده بود
mageh tou khbar ndari shab o rouz baraat bitabm	مگه تو خبر نداری شب و روز برات بیتابم؟
chera harfe goush nemi kony	چرا حرف گوش نمی کنی؟
misheh lotf kony aino begiri	میشه لطف کنی اینو بگیری؟
ageh gharareh kasi az in khuneh brh shoma hastin	اگه قراره کسی از این خونه بره شما هستین.
amma bad az chnd modat ba tars o vahshat biroon mi znd	اما بعد از چند مدت با ترس و وحشت بیرون می زند
ta tasirgozaari ejtemaai in nhadhai behdashti ra afzaayesh dahim	تا تاثیرگذاری اجتماعی این نهادهای بهداشتی را افزایش دهیم
bia inja bia inja	.بیا اینجا ، بیا اینجا
ozr khahi pazirofteh misheh	عذر خواهی پذیرفته میشه
jang jhani badi paiani brai zamin khahad boud	جنگ جهانى بعدى پایانى براى زمین خواهد بود
in sokoot arzesh dareh o rouz be rouz ghimtsh balatr mirh pas bi dalil nabayad shksth besheh	این سکوت ارزش داره و روز به روز قیمتش بالاتر میره پس بی دلیل نباید شکسته بشه
zibaayi raayegaan ast	زیبایی رایگان است !
khob bezaar be saeed begam	خوب ، بزار به سعید بگم
bs kon digeh dirmon misheh	بس کن دیگه دیرمون میشه
dorosteh khoobi ziad darhamkhab badihaie ham dareh	درسته خوبی زیاد داره،اماخب بدیهایی هم داره
rzh lbt rouye dhnsh malomh	رژ لبت روی دهنش معلومه
are mal mam mzkhrf boud	آره مال مام مزخرف بود
mikhahand tamam maharathaie lazem baray ayande ra dashth bashand	میخواهند تمام مهارتهای لازم برای آینده را داشته باشند
zani panjah salah por kar o por tlash o tasmim girndh baray ahl mahal	زنی پنجاه ساله پر کار و پر تلاش و تصمیم گیرنده برای اهل محل.
khob sria o bi sar o seda	خوب، سریع و بی سر و صدا
na ye dstgah ghmar bazi	نه یه دستگاه قمار بازی
choun mardom shoma ra be onvan yek shakhs mohem tarkibe mnhsrbh frdi az doo vijegi kelidi mibinnd	چون مردم شما را به عنوان یک شخص مهم ترکیب منحصربه فردی از دو ویژگی کلیدی میبینند
ta az shr un rahat besham	.تا از شر اون راحت بشم
chshmansh rezaa khan boud o man anghlab kbir fransh	چشمانش رضا خان بود و من انقلاب كبیر فرانسه
hes eshtebah khatarnak az amniat	حس اشتباه خطرناک از امنیت
baavaram nemisheh shohr dareh	باورم نمیشه شوهر داره
ma ashegh mosharekat dar msaal rouz hastim	ما عاشق مشارکت در مسائل روز هستیم
man eydeh hay khaasi daram	من ایده های خاصی دارم.
in chizi ast ke ma danshmndan ra zendeh ngh midard	این چیزی است که ما دانشمندان را زنده نگه میدارد
vay az artfaa mi trsm	وای، از ارتفاع می ترسم
man be yek sharike javan o baahoosh motasel shodeh bodam	من به یک شریک جوان و باهوش متصل شده بودم.
hey kari be aghaid mazhabi man ndashth bash basheh	هی کاری به عقاید مذهبی من نداشته باش ، باشه ؟
un che kari boud kardie	اون چه کاری بود کردی ؟
amma srakhr va dadand	اما سرآخر، وا دادند
che jouri etefagh miafth	چه جوری اتفاق میافته؟
bzarin bebinam chi chi migeh bego bego che blaii srt avardan	بزارین ببینم چی چی میگه. بگو بگو چه بلایی سرت آوردن؟
vali hamchenin biandazh saade mitavan ba zaman az yad board	ولی همچنین بیاندازه ساده میتوان با زمان از یاد برد
o un be tou chizi ngh	و اون به تو چیزی نگه ؟
ghaaedi shanbe mirh madrese ya mimonh khuneh bazi perspolise ro mibinh	قائدی شنبه میره مدرسه یا میمونه خونه بازی پرسپولیس رو میبینه؟
ie baba man chi migam shoma chi migi	ای بابا. من چی میگم. شما چی میگی؟
kheili ham chiz mhmi nist	خیلی هم چیز مهمی نیست
ya mitavand mian frzndantan bashad pas frzndantan ba frsthai baraabare rshd mikonand	یا میتواند میان فرزندانتان باشد، پس فرزندانتان با فرصتهای برابر رشد میکنند
ageh betunam oabstgih shdidm be shohr jan ro kam konam hameh chi aali misheh	اگه بتونم وابستگیه شدیدم به شوهر جان رو کم کنم همه چی عالی میشه
in tou nmaishnamh nist-	این تو نمایشنامه نیست-
chera hastam chera mondm chjori taght mi arm	چرا هستم؟ چرا موندم؟ چجوری طاقت می ارم؟
touye ye otagh band nmishn	توی یه اتاق بند نمیشن
amma ro hrfm hastam ke ghibt nknm	اما رو حرفم هستم که غیبت نکنم
tasmim migirand moshkel haml o naghl ra hol konand baray maloolaan jamahshan	تصمیم میگیرند مشکل حمل و نقل را حل کنند برای معلولان جامعهشان
tou ro khoda khaahesh mikonam	تو رو خدا خواهش میکنم
un ye doost dokhtar dareh	اون یه دوست دختر داره
khoda be maar pa nemi dah zaboon mi dah	خدا به مار پا نمی ده، زبون می ده.
o yek moalem madrese rahnmaii ke be aanhaa dar mavared tknolozhi dijital amouzesh midahad	و یک معلم مدرسه راهنمایی، که به آنها در مورد تکنولوژی دیجیتال آموزش میدهد
aya rahbaran jahani midannd ke che chizi ra se sal pish dar mjma omoomi amza krdhand	آیا رهبران جهانی میدانند که چه چیزی را سه سال پیش در مجمع عمومی امضا کردهاند
msla begiri bkhoabi sobh hmchin jaei bidar shi	مثلا بگیری بخوابی صبح همچین جایی بیدار شی
hala montazer doo bazi badmon ba aspania o prtghalim o omid be so'ood darim	حالا منتظر دو بازی بعدمون با اسپانیا و پرتغالیم و امید به صعود داریم
agar betor jedi mtahd shavand ta kari konand	اگر بطور جدی متعهد شوند تا کاری کنند
falaa tshiia jnazhst	فعلاً تشییع جنازهست
chetoure az on estefadeh konad	چطور از آن استفاده کند؟
man chizi nemigam dhnm ghrsh	من چیزی نمیگم. دهنم قرصه.
mesle un mardhaa hastam	مثل اون مردها هستم.
un jabe ro bezaar zamin	!اون جعبه رو بزار زمین
shayad khtkshm moshkel dareh	شاید خطکشم مشکل داره
ozift chieh khordan o khoabidn in jlf bazia ro bezaar kenar be fekr ye lghmh non bash	وظیفت چیه؟ خوردن و خوابیدن؟ این جلف بازیا رو بزار کنار به فکر یه لقمه نون باش.
beshin amnhkhodm dar ro baz mi konam	بشین امنه.خودم در رو باز می کنم.
neshoon midi rahat nistam	نشون میدی ، راحت نیستم
ma alaan kheili balaiim	ما الان خیلی بالاییم
vaghean kheili bashaori in raftaar bashar dostanto faramoush nemi konam	واقعاً خیلی باشعوری. این رفتار بشر دوستانتو فراموش نمی کنم.
mikhahand tknolozhi dijital o sabz ra biamouzand	میخواهند تکنولوژی دیجیتال و سبز را بیاموزند
chehre i aksrit gharib be etefagh asaatid fizike paaye dar daneshgah	چهره ی اکثریت قریب به اتفاق اساتید فیزیک پایه در دانشگاه
ba in khuneh i ghadimi khodaahaafezi konam	با این خونه ی قدیمی خداحافظی کنم
bazi oghtam ye khab nakhoshayand mibini o bad az in ke bidar mishi khdaroshkr mikoni ke vaghei nbodh	بعضی وقتام یه خواب ناخوشایند میبینی و بعد از این که بیدار میشی خداروشکر میکنی که واقعی نبوده
az man yaadegaari dashth baashin	از من یادگاری داشته باشین
un vaghean drdnak boud	اون واقعاً دردناک بود
chieh khb khoudam didam tou sfrh khuneh	چیه خب، خودم دیدم تو سفره خونه.
ma sroishai khoobi darim	ما سرویسهای خوبی داریم
migam misheh doubareh begid	میگم، میشه دوباره بگید
oonvaght manam misham hamkaarat	اونوقت منم میشم همکارت
panj dolar baray har jabe	.پنج دلار برای هر جعبه
sepas dar goshh ie ghaayem shod ta bbind che kasi on ra az masire brmidard	سپس در گوشه ای قایم شد تا ببیند چه کسی آن را از مسیر برمیدارد
digeh hichi brash mohem nist in hata bozorg ham besheh ye milyard dashth basheh be hamin rahati mibkhshh	دیگه هیچی براش مهم نیست این حتا بزرگ هم بشه یه میلیارد داشته باشه به همین راحتی میبخشه،
ma ba ham rabeteh darim	ما با هم رابطه داریم ؟
be zan daare o bi zan nist khilia shoono ainjorin	به زن دار و بی زن نیست خیلیا شون اینجورین
man faghat inja kar mikonam	من فقط اینجا کار میکنم
vali janson oaghaa hasaseh	ولی جانسون واقعا حساسه
misheh hasan hmrahmon biad	میشه حسن همراهمون بیاد؟
bikhod khodtono khsth nkninnmitonin bnoisinhrchi noshtin paak knin	بیخود خودتونو خسته نکنین،نمیتونین بنویسین،هرچی نوشتین پاک کنین
un kheili zoud baorh	اون خیلی زود باوره
poul belit dar jibm maand	پول بلیط در جیبم ماند
ba garanti kaml bazi oghtha baste be sharayet bazar o reghaabat	با گارانتی كامل، بعضی وقتها بسته به شرایط بازار و رقابت
zibaayi navar ast o penhan nemimaanad	زیبایی نور است و پنهان نمیماند
amma be hich ojh na motavajeh mishd o na dast bardar boud	اما به هیچ وجه نه متوجه میشد و نه دست بردار بود
ke mikhoai bala biari	که میخوای بالا بیاری ؟
be hamin khater ba yek board o yek baakht momkene ast jaayegaahe tim ha jabja shood	به همین خاطر با یک برد و یک باخت ممکن است جایگاه تیم ها جابجا شود
ageh alaan boud un chehel nafar shish sdta shekayat azt mi kardan maman	اگه الان بود اون چهل نفر شیش صدتا شکایت ازت می کردن مامان.
engaar chharshnbh sori boud engaar eyd boud shabih hameh chiz boud aonshb	انگار چهارشنبه سوری بود انگار عید بود شبیه همه چیز بود اونشب !!
in mavaared be faarsi brgrdanshdhand	این موارد به فارسی برگردانشدهاند
man nghsh midarm baba	من نگهش میدارم ، بابا
ye madrshohrdarm ageh az dastesh naaraahat basham kheili rahat mitoonam behesh bgmkhili rahat mitoonam baahaash bahs konam	یه مادرشوهردارم: اگه از دستش ناراحت باشم خیلی راحت میتونم بهش بگم،خیلی راحت میتونم باهاش بحث کنم
choun injouri sigar ro dast shrkta baad miknh bad majbour mishn arzon bfroshn	چون اینجوری سیگار رو دست شركتا باد میكنه، بعد مجبور میشن ارزون بفروشن
drbarh oaldinm mi donh	درباره والدینم می دونه
dghaigh aval feshar ziadi ro baziknamon boud o be tarz vahshatnaaki astrs dashtim	دقایق اول فشار زیادی رو بازیکنامون بود و به طرز وحشتناکی استرس داشتیم
o az nazar saazmaani chegouneh mitavanid sharaayeti khalgh konid	و از نظر سازمانی، چگونه میتوانید شرایطی خلق کنید
perspolise bbrh ba shor o hayajan mirim be astghbal thrimha	پرسپولیس ببره با شور و هیجان میریم به استقبال تحریمها
dar mavared inke che chiz shodani ast o nshdni	در مورد اینکه چه چیز شدنی است و نشدنی
tahala touye amrm didam	تاحالا توی عمرم دیدم
baray ye modat bd nist ye tnoai eijad misheh	برای یه مدت بد نیست یه تنوعی ایجاد میشه
ta dar mavared esteraatezhi ke be aatghadm baray sherkat dorost boud tozih daham	تا در مورد استراتژی که به اعتقادم برای شرکت درست بود توضیح دهم
in bishhai az ney o kheyzaraan ast	این بیشهای از نی و خیزران است
tjma admaii ke azshghlshon mtnfrn amabhsh majbour omhkom	تجمع آدمایی که ازشغلشون متنفرن امابهش مجبور ومحکوم!
alaan ehsas behtary dari	الان احساس بهتری داری؟
khodaya komakam kon	خدایا کمکم کن
piremarde faghiri ke behtarin mard jahan shenaakhte shod	پیرمرد فقیری که بهترین مرد جهان شناخته شد
faghat aonjash ke doubareh nafas migirh o zoor mizaneh	فقط اونجاش که دوباره نفس میگیره و زور میزنه
man mi khum komak konam	من می خوام کمک کنم
tohin konid bitojhi konid ya nadide begirid	توهین کنید، بیتوجهی کنید یا نادیده بگیرید
ye kam khshkh vali hameh azash	یه کم خشکه ولی همه ازش
alsh ta mantoba ye angshtr o safar kish	ال:سه تا مانتو،با یه انگشتر و سفر کیش
vaghti yek srmaihgzar agah pidaish mishod	وقتی یک سرمایهگذار آگاه پیدایش میشود
ta inke saregh hrfh ie shodam	تا اینکه سارق حرفه ای شدم
chieh setaare dnbalh daare	چیه ستاره دنباله دار؟
mitavaanand be shoma paasokh dahand hti vaghti tasmim darid nashnas bmanid	میتوانند به شما پاسخ دهند حتی وقتی تصمیم دارید ناشناس بمانید
shayad se rouz dighshaid se hafteh digeh o ya shayad chndmah bad	شاید سه روز دیگه،شاید سه هفته دیگه و یا شاید چندماه بعد
na tamoom nist ta vaghti	نه ، تموم نیست تا وقتی
inja aintori baghal kon	اینجا، اینطوری بغل کن
ye sham mkhtsr dorost koneh	.یه شام مختصر درست کنه
ou dar hal sohbat rah raft o az mdiransh niaz hamin togha ra dasht	او در حال صحبت راه رفت، و از مدیرانش نیز همین توقع را داشت
man be kioi alrzhi daram	من به کیوی آلرژی دارم
ba aoloitbndi harime khosusi o amniat aanhaa mitavaanand etemaad o vafaadaari dar kaarbaraane khod eijad konand	با اولویتبندی حریم خصوصی و امنیت، آنها میتوانند اعتماد و وفاداری در کاربران خود ایجاد کنند
madrshohrshmahm ye karaii mikone iahrfaii mizaneh ke baes besheh pesaresh o ya atrafian behesh madyoon bashan	مادرشوهرشماهم یه کارایی میکنه یاحرفایی میزنه که باعث بشه پسرش و یا اطرافیان بهش مدیون بشن؟
ye lahze goushi ro negahdaar	یه لحظه گوشی رو نگهدار
mi khoad estefadeh koneh	می خواد استفاده کنه ؟
paadeshah az in skhn vazir brashft o az raftaar ou dar baraabare in etefagh azrdh khater shod	پادشاه از این سخن وزیر براشفت و از رفتار او در برابر این اتفاق ازرده خاطر شد.
ghalam ra rouye kaaghaz gozashtam mikhastam be ou befahmaanam ke kar fori o foti daram	قلم را روی کاغذ گذاشتم، میخواستم به او بفهمانم که کار فوری و فوتی دارم
be shomaahaa ham begam kachal bshid	به شماها هم بگم کچل بشید
man un ro yek shbh noshtm	من اون رو یک شبه نوشتم
salam imaan salam imaan	سلام ایمان. سلام ایمان
na na baziro kharab nakon	نه نه بازیرو خراب نکن
ma alaan kheili balaiim	ما الان خیلی بالاییم
man ghbla aintori naboodam	من قبلا اینطوری نبودم
pas digeh naaraahat nisti	پس دیگه ناراحت نیستی؟
hasht ta jojeh darim	هشت تا جوجه داریم
az kode takhfif estefadeh kon	از کد تخفیف استفاده کن
be khodet negah kon	به خودت نگاه کن!
baray man yekam shokr brizid	برای من یکم شکر بریزید
bayad havaasash roprt konim	باید حواسش روپرت کنیم
mi tonam in karo bokonam	.می تونم این کارو بکنم
bad ye modat adat mi kony	بعد یه مدت عادت می کنی
khuneh man booye ajibi midh	خونه من بوی عجیبی میده
akhh digeh hrchizi hedie dareh khoda	آخه دیگه هرچیزی حدی داره خدا
ntrs pessar shjaa ntrs kari be kaart nadaram mi khndd	نترس پسر شجاع. نترس کاری به کارت ندارم. می خندد
shloart ro taraf man nagir	شلوارت رو طرف من نگیر
chikar daarin mi knin	چیکار دارین می کنین ؟
un alaan oaghaa narahth	اون الان واقعا ناراحته
«hml kardan yek oizhgi» dar on lahze chip fahmide amighaa dar drdsr aftadh	«حمل کردن یک ویژگی»؟ در آن لحظه، چیپ فهمید عمیقاً در دردسر افتاده
choun be ma miguyad ke aanhaa negaraanand	چون به ما میگوید که آنها نگرانند
choun ba amalkard khob dar msaal pish ro	چون با عملکرد خوب در مسائل پیش رو
vali un alaan ba imaan hastesh	ولی اون الان با ایمان هستش
azadh labkhand be lb o kheyreh o motafaker az khaneh biroon mi aid	ازاده لبخند به لب و خیره و متفکر از خانه بیرون می اید.
ageh sar o klh i tou peyda nashode boud	اگه سر و کله ی تو پیدا نشده بود
jaei ke adamha mitavaanand biaayand o aidhha o rahhlhaishan ra be ashtrak bgzarnd	جایی که آدمها میتوانند بیایند و ایدهها و راهحلهایشان را به اشتراک بگذارند
tahala pesari behem ebraze alagheh nakardeh boud vabehem pishnahade ashnaii nadadeh boud nemidoonestam chikar konam	تاحالا پسری بهم ابراز علاقه نکرده بود وبهم پیشنهاد اشنایی نداده بود نمیدونستم چیکار کنم
man am goftam kou goush shnoa zhra khanoum ro ke mi shnasi	من ام گفتم. کو گوش شنوا! زهرا خانوم رو که می شناسی!
behtarin barkhord ba ksi ke ashghal mi ndazh biroon	بهترین برخورد با كسی كه اشغال می ندازه بیرون
fibi ye daghigheh sabr kon	فیبی ، یه دقیقه صبر کن
pas tou inja kar mikoni	پس تو اینجا کار میکنی
brgha ra rouye zamin mi rizd khod ra moratab mi konad o be samt dar mi rod	برگها را روی زمین می ریزد خود را مرتب می کند و به سمت در می رود.
o shadish bad az amali kardan in pishnahade chnd baraabare shod	و شادیش بعد از عملی کردن این پیشنهاد چند برابر شد
are o mamnoon mishim	آره و ممنون میشیم
daram miram tou tloizion	!دارم میرم تو تلویزیون
pas mi khoain hmon kot she ro biarin	پس می خواین همون کت ش رو بیارین.
blh ke ba shoma bodam	بله که با شما بودم.
in aks dkhtrth mageh na	این عکس دخترته مگه نه؟
hameh ja vojood darad o nshanhhaii hastand ke bayad eslaahaat sourat gird	همه جا وجود دارد، و نشانههایی هستند که باید اصلاحات صورت گیرد
ye sor o saat mofasal o hameh ram khbar konim	یه سور و سات مفصل و همه رم خبر کنیم.
pashim berim ghnd o shokr o roghnmon ro begirim ta tamoom nashode	پاشیم بریم قند و شکر و روغنمون رو بگیریم تا تموم نشده
vaghti ou ra bazdasht kardam rouye polo az asb be zamin aftadh o minalid	وقتی او را بازداشت کردم روی پل از اسب به زمین افتاده و مینالید
aia ma ham hamin jorim	ایا ما هم همین جوریم؟
saeed migeh mi khoad hasan asir koneh	سعید میگه می خواد حسن اسیر کنه
baraabare rasm khaanevaade hay bozorg mkh mohamad ra be daih ie be naam hlimh sepord	برابر رسم خانواده های بزرگ مکه محمد را به دایه ای به نام حلیمه سپرد.
javaab on ra har rouz ba raftaaretaan midahid	جواب آن را هر روز با رفتارتان میدهید
amma hif ke alaan hssh nistbashh jmah badii	اما حیف که الان حسش نیست،باشه جمعه بعدی
trsi ke dar del yek mdiraaml sherkat o hiat mdirh eijad mikonand	ترسی که در دل یک مدیرعامل شرکت و هیات مدیره ایجاد میکنند
pesari ke salhabod bache daare nmishdo khanoadsh brash koli doa kardan	پسری که سالهابود بچه دار نمیشدو خانوادش براش کلی دعا کردن
znha mi khoannd o sar khoshi mi konand	زنها می خوانند و سر خوشی می کنند.
mdam goshhgirtr mishavid	مدام گوشهگیرتر میشوید؟
sharzh goushi shoma tamam mishod	شارژ گوشی شما تمام میشود
chenaanche ghsm yad karde ke man digar harfi nadaram	چنانچه قسم یاد کرد که من دیگر حرفی ندارم
na ye vasile sargarmi ke	نه یه وسیله سرگرمی که
ke ba mdiraaml o hiat mdirh o har shnondh digari drbarhash harfe mizanad	که با مدیرعامل و هیات مدیره و هر شنونده دیگری دربارهاش حرف میزند
karkonan bishtar az har chiz az rhbranshan che chizi mikhahand	کارکنان بیشتر از هر چیز از رهبرانشان چه چیزی میخواهند؟
raychel ro mamani seda konam	ریچل رو مامانی صدا کنم
chetoure fhmidi man ainjam	چطور فهمیدی من اینجام؟
morchh hameh ro mi khorh jz ghm saheb khuneh ro	مورچه همه رو می خوره جز غم صاحب خونه رو
chetoure momkeneh lng ye moush nim ojbi bshi	چطور ممکنه لنگ یه موش نیم وجبی بشی؟
az mrzhai siarhai tjaoz mikonim	از مرزهای سیارهای تجاوز میکنیم
harfhaayi ke tou ghooti hich atari peyda nemisheh eyneh ke amrikaainghdr pishrafte kardeh	حرفهایی که تو قوطی هیچ عطاری پیدا نمیشه اینه که امریکااینقدر پیشرفت کرده
motorhai jstjo dar javaab dadan be shoma aali hastand	موتورهای جستجو در جواب دادن به شما عالی هستند.
na agha hich chiz faghat yek rismaan peyda kardam ke kenar rishe drkht azad aftadh boud	نه اقا، هیچ چیز، فقط یک ریسمان پیدا کردم که کنار ریشه درخت ازاد افتاده بود
jdaa hal dkhtrmon aslaa khob nist khaanom aino babr doktor ta kar dstmon nadadeh	جداً حال دخترمون اصلاً خوب نیست. خانم اینو ببر دکتر تا کار دستمون نداده.
refigh in doost dokhtar mnh	رفیق این دوست دختر منه
dar hangam oaghah o bad az on che ehsasi be shoma dast dad	در هنگام واقعه و بعد از آن چه احساسی به شما دست داد؟
ghozk paye man khpl nist	!قوزک پای من خپل نیست
doostaan madrbzrgt chetoure	دوستان مادربزرگت چطور؟
na digar az an jasad khoon nmiamd fekr mikonam ke zkhm khoshk shodeh boud	نه دیگر از ان جسد خون نمیامد، فکر میکنم که زخم خشک شده بود.
o az hameh bishtar be srmaihgzarni ke baghieh shrktha ra mtghaad konand ta mesle adidas raftaar konand	و از همه بیشتر به سرمایهگذارنی که بقیه شرکتها را متقاعد کنند تا مثل آدیداس رفتار کنند
oonja boud ke fahmidam az daneshgah akhrajm kardan	اونجا بود که فهمیدم از دانشگاه اخراجم کردن
un behtarin barnameh hast	اون بهترین برنامه هست
bardaasht o mesle ye zan shod	برداشت و مثل یه زن شد
az mian in se laoitmn hanouz zendeh ast	از میان این سه، لاویتمن هنوز زنده است
choun un naghsh kheili khoubeh	چون اون نقش خیلی خوبه
lahze oghoa zlzlh dar yeki az froshgah hay shahr aslam abadghrb kermanshaah	لحظه وقوع زلزله در یکی از فروشگاه های شهر اسلام آبادغرب کرمانشاه
mashino gozashteh biroon aomdn kapotsho dzdidn faghat	ماشینو گذاشته بیرون اومدن کاپوتشو دزدیدن فقط
ya mashin chizish shodeh ke polis mi fhmh az jaaye barkhord moghaser kih	یا ماشین چیزیش شده که پلیس می فهمه از جای برخورد مقصر کیه
ba yek morabi o meghdari boodje yek ap jadid tarahi kardeand ke be jamahshan komak mikonad	با یک مربی و مقداری بودجه، یک اپ جدید طراحی کردند که به جامعهشان کمک میکند
khob deght kninmidanid chera adm nemishim	خوب دقت کنین،میدانید چرا ادم نمیشیم؟
aghamon hamishe tarifsh ro mi koneh ke kheili mard boudeh	اقامون همیشه تعریفش رو می کنه که خیلی مرد بوده
o kashef sarzamin hay doraftadh dar gorooh panjah o chahar	و کاشف سرزمین های دورافتاده در گروه پنجاه و چهار
aval az hameh jimzkomi dorost fhmidhbod	اول از همه، جیمزکومی درست فهمیدهبود
kami bozorgtar shood o agar khodesh khast o doost dasht be entekhaab khodesh barayash mikhrm	کمی بزرگتر شود و اگر خودش خواست و دوست داشت، به انتخاب خودش برایش میخرم
az bimaari nadari ranj mi board	از بیماری نادری رنج می برد.
bro vaase ghrar davatesh kon	برو واسه قرار دعوتش کن
amma akhrsh madrshohrm brgsht gftainm ba goftan man tanbalam khodsho rahat kardeh	اما آخرش مادرشوهرم برگشت گفت،اینم با گفتن من تنبلم خودشو راحت کرده
ta hala barayash tofang nkhridham	تا حالا برایش تفنگ نخریدهام
chera dari ou ra sosol baar miaavari	چرا داری او را سوسول بار میاوری؟
nazdik zohr dirooz boud	نزدیک ظهر دیروز بود؟
mard gftmhm nist emrouz sood kardam	مرد گفت:مهم نیست امروز سود کردم.
ma momkene ast ghasd ndashth bashim in ehsas ra be kasi bdhim amma vaghti in kar ra kardim aoaghbi darad	ما ممکن است قصد نداشته باشیم این احساس را به کسی بدهیم، اما وقتی این کار را کردیم، عواقبی دارد
vaghti az hghoght razi nisti	وقتی از حقوقت راضی نیستی
fekr mikoni taghsir khodshh	فکر میکنی تقصیر خودشه؟
mahram tarin fard zendegim mahsa st	محرم ترین فرد زندگیم مهسا ست
amma nemi donn ke oonja jaaye kheili khtrnakih	اما نمی دونن که اونجا، جای خیلی خطرناکیه
in mavared zang khtr ra baray man be seda draord choun hrfh man hemaayat az hghogh masraf konandegan ast	این مورد زنگ خطر را برای من به صدا درآورد، چون حرفه من حمایت از حقوق مصرف کنندگان است
hameh doost darim dar goshh bala samt rast bashim amn o jahani monaaseb baray ayande	همه دوست داریم در گوشه بالا سمت راست باشیم، امن و جهانی مناسب برای آینده
"danshgah hai ma ye rshtha ""nmkـ shnasi"" km darn "	"دانشگاه هاى ما یه رشتهء ""نمكـ شناسى"" كم دارن "
o aanhaayi ke dar madrese hastand ehsas mikonand ke maharathaie dorost ra nmiamoznd	و آنهایی که در مدرسه هستند احساس میکنند که مهارتهای درست را نمیآموزند
bayad eshtebah shmrdh basham	باید اشتباه شمرده باشم
pesarak ba shojaa'at khod ra amadh marg kardeh bodchon fekr mi karde ke ghrar ast tamam khoonash ra be khaharash bedahad	پسرک با شجاعت خود را اماده مرگ کرده بود،چون فکر می کرد که قرار است تمام خونش را به خواهرش بدهد!
aasabm un shab khoord boud	اعصابم اون شب خورد بود
hast ye chnd rouzi saei kardam kasi nfhmh ta ikhordh khodesh del o damaagh peyda koneh bad	هست یه چند روزی. سعی کردم کسی نفهمه تا یخورده خودش دل و دماغ پیدا کنه، بعد
azmayesh anjam midadh nsht kardeh ast	آزمایش انجام میداده، نشت کرده است
az didn man ta'ajob kardie	از دیدن من تعجب کردی ؟
ageh doo daghigheh ham bikar bashn ktabshono va mikonan o shorou be khoundan mikonan	اگه دو دقیقه هم بیکار باشن کتابشونو وا میکنن و شروع به خوندن میکنن
bad chnd daghigheh ba maman raftam biroon	بعد چند دقیقه با مامان رفتم بیرون
nahve tlfz namm ra biamozid	نحوه تلفظ نامم را بیاموزید
az oonja man dashtam	. از اونجا من داشتم
sbhonh rouz jmah bayad aintori basheh olaghir	صبحونه روز جمعه باید اینطوری باشه ولاغیر
aia be azadi aradh aghaeideh darid	ایا به ازادی اراده عقیده دارید؟
alaan mi tonh mesle yek parkor kar az rouye moana bprh o jabja besheh	الان می تونه مثل یک پارکور کار از روی موانع بپره و جابجا بشه
man fekr konam hanouz bironh	من فکر کنم هنوز بیرونه
ye vaght khob pish nayoomade	یه وقت خوب پیش نیومده
mi khum bezaram ye chizi bebini	می خوام بذارم یه چیزی ببینی
boudi azt zorgiri karde	بودی ازت زورگیری کرد ؟
tamam shab tou ataghm boudeh	.تمام شب تو اتاقم بوده
sdha milion ba astsmar robh ro hastand o soastfadh o khoshoonat	صدها میلیون با استثمار روبه رو هستند و سواستفاده و خشونت
oonja ro ba un atobosh mi tonam beram khuneh	اونجا رو، با اون اتوبوسه می تونم برم خونه
rosri an zan frou aftadh boud o chhrhash ra makhfi kardeh boud	روسری ان زن فرو افتاده بود و چهرهاش را مخفی کرده بود
o jaei nadaarim ke berim	.و جایی نداریم که بریم
hich kase tabhal tlashi baray tarkibe thlili ahdaafe tose'e paydar ba mrzhai siarhai nakardeh ast	هیچ کس تابحال تلاشی برای ترکیب تحلیلی اهداف توسعه پایدار با مرزهای سیارهای نکرده است
pas ma donbal rahhlhai pishrfth hastim rahhlhai jadid	پس ما دنبال راهحلهای پیشرفته هستیم راهحلهای جدید
amma ghodrat ba tkhil koudak shoma mmzoj nemishavad	اما قدرت با تخیل کودک شما ممزوج نمیشود
in iaro drough migeh shoma chera bavar mi knin tou ro khoda yeki manoo nejat bedeh	این یارو دروغ میگه شما چرا باور می کنین. تو رو خدا یکی منو نجات بده.
az yek paigah nezaami dar aamrikaa ke baray tolid salaah biolozhiki	از یک پایگاه نظامی در آمریکا که برای تولید سلاح بیولوژیکی
rah digari baray anjamsh hast	راه دیگری برای انجامش هست
blh hrki az ye chizi mi kshh yeki az donsth hash yeki az ndonsth hash	بله هرکی از یه چیزی می کشه یکی از دونسته هاش یکی از ندونسته هاش.
ye tikeh digeh az khashghchi ro peyda kardam	یه تیکه دیگه از خاشقچی رو پیدا کردم
oomad jelo goft khsth nabaashin	اومد جلو گفت خسته نباشین
shmam hmchin madrshohri daarin	شمام همچین مادرشوهری دارین؟
emrouz hich kari nakardam o faghat az atmsfr paiiz lezat bordam	امروز هیچ کاری نکردم و فقط از اتمسفر پاییز لذت بردم
ma mohit modbanhtri darim	ما محیط مودبانهتری داریم
davam inke noe shavahed mohem ast	دوم اینکه نوع شواهد مهم است
aina digeh mzahm be hesaab nmian	اینا دیگه مزاحم به حساب نمیان
chahardah emteyaz darim o ba tim sevom jadval faghat doamtiaz faseleh darim	چهارده امتیاز داریم و با تیم سوم جدول فقط دوامتیاز فاصله داریم
rahat bash chadrt ro dar biar amnh jan	راحت باش. چادرت رو در بیار امنه جان.
oh manam az un mikham	اوه منم از اون میخوام
pezeshk maaljozait bimaari minaa ra baray baraadar hfte salah ou tozih dad	پزشک معالج،وضعیت بیماری مینا را برای برادر هفت ساله او توضیح داد
amma shoma ghol dadin azash mraghbt knin	اما شما قول دادین ازش مراقبت کنین
unha hamdigeh ro darn	اونها همدیگه رو دارن.
amasbsh digeh ashti kardim o raft sarkaar	اماصبش دیگه آشتی کردیم و رفت سرکار
o dar nahhayat pnjm afzaishi shodid dar thsilato bhdasht bishtar	و در نهایت، پنجم، افزایشی شدید در تحصیلاتو بهداشت بیشتر
dar har hal ainkaro kardie	در هر حال اینکارو کردی
jalbh bdonid ke aksar ghatlin sــriali marof mtoldin aabaan mah hastand	جالبه بدونید که اکثر قاتلین ســریالی معروف ، متولدین آبان ماه هستند
choun aintori mi tonam	چون اینطوری می تونم
chizi ro mstsni mikoni	چیزی رو مستثنی میکنی؟
ma be donbal kar kardan bishtar dar zendegi hastim o hamchenaan kamtar o kamtar ehsas ghrabt mikonim	ما به دنبال کار کردن بیشتر در زندگی هستیم، و همچنان کمتر و کمتر احساس قرابت میکنیم
ageh bkshimsh mi tonim bebarimesh oonja	اگه بکشیمش، می تونیم ببریمش اونجا
basheh kheili khb , basheh	باشه ! خیلی خب , باشه
ta inja behtarin mogheeat perspolise taoiz khiabani boudeh	تا اینجا بهترین موقعیت پرسپولیس تعویض خیابانی بوده
man midounam ke hagh ba mnh	من میدونم که حق با منه
man pish danshgahi bodam	من پیش دانشگاهی بودم
jaaye khalit o chjori mitoonam baazam bebinam	جای خالیت و چجوری میتونم بازم ببینم؟
be nazaram in mojasame ra az rouye mraghbaie emtehaan dar iran bastan sakhtan	به نظرم این مجسمه رُ از روی مراقبایِ امتحان در ایران باستان ساختن
prsidnd che mi kony	پرسیدند : چه می کنی ؟
enekaas mosbat dehid o aatbar bebakhshid	انعکاس مثبت دهید و اعتبار ببخشید
dar bishtar mavaared aazaar o tbaiz yek tajrobe enzevaa o tnhaiiaor ast	در بیشتر موارد آزار و تبعیض یک تجربه انزوا و تنهاییآور است
inja in ro negah kon	اینجا، این رو نگاه کن
tasmimaat khodavand az ghodrat dark ma kharej ast amma hamishe be sood ma mi bashad	تصمیمات خداوند از قدرت درک ما خارج است اما همیشه به سود ما می باشد
rouzi paadeshah baray poost kandan mive kaarde tizi talab karde amma dar hine boridane mive angoshtash ra berid	روزی پادشاه برای پوست کندن میوه کارد تیزی طلب کرد اما در حین بریدن میوه انگشتش را برید
gzarshhai in kargrouh be dast vazir kharejeh reside o ou in gzarshhai ra be mikhaail gorbachof dad	گزارشهای این کارگروه به دست وزیر خارجه رسید و او این گزارشهای را به میخائیل گورباچوف داد
o biaiid anjamsh dahim	و بیایید انجامش دهیم
mi khoastm beram hazer shm	می خواستم برم حاضر شم
mrimdst o pnjh tou bayad tala gereft	مریم،دست و پنجه تو باید طلا گرفت
azizam manam doostat daram	عزیزم ، منم دوستت دارم
chenaanche ghsm yad karde ke man digar harfi nadaram	چنانچه قسم یاد کرد که من دیگر حرفی ندارم
chetoure dlton miad in har chi ham ke basheh baz ham ye moshh ye moush bdbkhto mflokh	چطور دلتون میاد؟ این هر چی هم که باشه باز هم یه موشه. یه موش بدبختو مفلوکه.
dast be delesh mi gird o be zamin mi aftd kaaram tmomh	دست به دلش می گیرد و به زمین می افتد کارم تمومه.
tamas shoma baray ma mohemeh	.تماس شما برای ما مهمه
khb chera behet drough begam	خب ، چرا بهت دروغ بگم
takhir ejtemaai takhir siasi takhir dar joamashan	تغییر اجتماعی، تغییر سیاسی تغییر در جوامعشان
un ba man be goor mirh	!اون با من به گور میره
toop hamash dast mrakshia boud	توپ همش دست مراکشیا بود
be raanande migi mi khoai brgrdi pish mamant	به راننده میگی می خوای برگردی پیش مامانت
srghimt be tfahm resiadan o kelide ro dad behemoon o	سرقیمت به تفاهم رسیدن و کلید رو داد بهمون و
khoahrm migeh jdida chghd tazgiha por harfe shdiamaaltshonmiprsh	خواهرم میگه جدیدا چقد تازگیها پر حرف شدی،اماعلتشونمیپرسه
shab bidari o bi khaabi azitt nknh	شب بیداری و بی خوابی اذیتت نکنه
asla moshkeli nist basheh	اصلا مشکلی نیست باشه ؟
man kmkton mi konam	من کمکتون می کنم
un tmizshon nakardeh boud	اون تمیزشون نکرده بود
ba yek mosaahebe bd mitavan joziyaate ra faramoush karde ya bd bekhaatere avarde	با یک مصاحبه بد میتوان جزییات را فراموش کرد یا بد بخاطر آورد
in dastan man brmigrdh be chnd sal pish	این داستان من برمیگرده به چند سال پیش
dalil asli in boud ke timhaii ke dar marz gstakhi hastand etelaat ra be rahati be ashtrak nmigzashtnd	دلیل اصلی این بود که تیمهایی که در معرض گستاخی هستند اطلاعات را به راحتی به اشتراک نمیگذاشتند
aya amalkard afrad oaghaa aasib mibinad man dar in mavared ham knjkao bodam	آیا عملکرد افراد واقعا آسیب میبیند؟ من در این مورد هم کنجکاو بودم
hich sooraakhi oonja nist	.هیچ سوراخی اونجا نیست
salam raychel geryan hastam	سلام . ریچل گرین هستم
bazi az ma momkene ast on ra gostaakhaane bdanim baghieh momkene ast on ra kamla modbanh bdannd	بعضی از ما ممکن است آن را گستاخانه بدانیم، بقیه ممکن است آن را کاملا مودبانه بدانند
afrad ebraze nashode ra be edameh sohbat faraa bkhoanid	افراد ابراز نشده را به ادامه صحبت فرا بخوانید
oala nemi donm un kheili adm mozih	والا نمی دونم، اون خیلی ادم موذیه
ke rafteh o manam srdmh	.که رفته و منم سردمه
khb bebakhshid baray in kar	خب ببخشید برای این کار
in gheyr ghaabel bavar hast	این غیر قابل باور هست
amidoarm baba movafagh besheh	امیدوارم بابا موفق بشه
goft chharm abtdaii bodam o rouzi az madrese baz gshtm dar hali ke medad siahm gom shodeh boud	گفت: چهارم ابتدایی بودم و روزی از مدرسه باز گشتم در حالی که مداد سیاهم گم شده بود
khob,chh charh ie dashtm-	خوب,چه چاره ای داشتم؟-
ageh man saaghdoosh tou bashm,	اگه من ساقدوش تو باشم,
htma ye kash ie zire nim kash ast	حتما یه کاسه ای زیر نیم کاسه است
ke mitavand ma ra be fazaye amliati amn beresand o ahdaafe amidoarknndh ejtemaai o eghtesaadi ra mohaghagh konad	که میتواند ما را به فضای عملیاتی امن برساند و اهداف امیدوارکننده اجتماعی و اقتصادی را محقق کند
agar ma pey bbrim ke dar hal mshahdh o nzart hastim ma raftaar khodemaan ra takhir khaahim dad	اگر ما پی ببریم که در حال مشاهده و نظارت هستیم، ما رفتار خودمان را تغییر خواهیم داد
ke hich vaght in ro ngin	که هیچ وقت این رو نگین
mageh nemi geh tou ataghh man raftam touye ashpzkhonh	مگه نمی گه تو اتاقه! من رفتم توی اشپزخونه.
asiaban gndm ou ra dar kenar saayer kise ha gozaashte ta be nobat ard konad	آسیابان گندم او را در کنار سایر کیسه ها گذاشت تا به نوبت آرد کند
ghaayem moshk bazha hastin	.قایم موشک بازها هستین
koja tashrif dashth baashin digeh	کجا، تشریف داشته باشین دیگه
drnhait akharin hlghh in paazel tkmilshdh	درنهایت آخرین حلقه این پازل تکمیلشده
yeki dareh migeh raft bala yeki migeh mikeshe payien yeki migeh aina bazishonh	یکی داره میگه رفت بالا، یکی میگه میکشه پایین، یکی میگه اینا بازیشونه
ye parandeh nadidan	یه پرنده ندیدن؟
zahmat mi sheh mi girm khoudam	زحمت می شه. می گیرم خودم.
khdaiish in dar shan final asia nist alaan digeh bayad zrshk plo ba morgh midadn	خداییش این در شأن فینال آسیا نیست الان دیگه باید زرشک پلو با مرغ میدادن
mibaram mi grdonmshjasho tamiz mi konam	میبرم می گردونمش،جاشو تمیز می کنم
vali dar in otagh bkhsos ehsas yek taze kar dar bayan nabghhhai tknolozhi ra dashtam	ولی در این اتاق بخصوص، احساس یک تازه کار در بین نابغههای تکنولوژی را داشتم
hmontor ke mi binin yekishoon kmh	همونطور که می بینین، یکیشون، کمه
chnd rouz bad paadeshah ba mlazmansh baray shekaar be nazdiki jngli rftnd	چند روز بعد پادشاه با ملازمانش برای شکار به نزدیکی جنگلی رفتند
mordeh shor in smak bbrh	مرده شور این سمعک ببره
ghol mi dahad an hayoolaa ra zendeh begirad o biavarad	قول می دهد ان هیولا را زنده بگیرد و بیاورد
ye modat ba khahar mohsen ham tlfni ashna shodeh bodam o ounam az rabeteh o alagheh ma khbar dasht	یه مدت با خواهر محسن هم تلفنی اشنا شده بودم و اونم از رابطه و علاقه ما خبر داشت
man nemi tonam gosht bokhoram	من نمی تونم گوشت بخورم
mardi dar namayeshgahi goldaan mi forookht	مردی در نمایشگاهی گلدان می فروخت
znha riz mi khndnd nejabat o shraft koja boud	زنها ریز می خندند نجابت و شرافت کجا بود؟
oabsthha mjozha o janshinanhai on gheyr ghaabel jobraane ke yani shoma nemi toanid nazar khod ra takhir dehid	وابستهها، مجوزها و جانشینانهای آن غیر قابل جبران که یعنی شما نمی توانید نظر خود را تغییر دهید
in be jzabit lig ezafeh mi konad o ma ham baray resiadan be rdh hay balatr tlash mi konim	این به جذابیت لیگ اضافه می کند و ما هم برای رسیدن به رده های بالاتر تلاش می کنیم
khoda shans bedeh ye shbh adma dara mi shn	خدا شانس بده یه شبه ادما دارا می شن!
migam bhtrh ye khordeh bkhoabi	میگم بهتره یه خورده بخوابی
misheh zip manoo bdi bala	میشه زیپ منو بدی بالا؟
rafti komak chera bdsh biad	رفتی کمک چرا بدش بیاد؟
baray ketab kharidan lebas kharidan pesaram masiha ranghaye mokhtalef lebas darad	برای کتاب خریدن، لباس خریدن پسرم مسیحا رنگهای مختلف لباس دارد
man pish danshgahi bodam	من پیش دانشگاهی بودم
man aghaye flahi hastam	من آقای فلاحی هستم
mkalmat zbt shodeh bache doostaan o khaanevaade baray ahdaafe tblighati mitavanest estefadeh shood	مکالمات ضبط شده بچه، دوستان و خانواده، برای اهداف تبلیغاتی میتوانست استفاده شود
paasokh dad dar in nazdiki chshmh abi hast o man moratab noke khod ra por az ab mi konam o an ra rouye atsh mi rizm	پاسخ داد : در این نزدیکی چشمه ابی هست و من مرتب نوک خود را پر از اب می کنم و ان را روی اتش می ریزم !
khodaya che donyaaye kochikih	خدایا چه دنیای کوچیکیه
kashfaii ke elaam mi konim	کاشفایی که اعلام می کنیم
ghrar gereftan drmian ghodrat hay jahan	قرار گرفتن درمیان قدرت های جهان
o dar zminh sanat mizbani etelaat anbashth daram	و در زمینه صنعت میزبانی اطلاعات انباشته دارم
azadh joun che khbar	ازاده جون چه خبر؟.
mitavanam ba javanan sohbat o molaaghaate konam o bshnomshan az hameh jaaye donya	میتوانم با جوانان صحبت و ملاقات کنم و بشنومشان از همه جای دنیا
amsal dar lig torkeyeh bazi mi konad	امسال در لیگ ترکیه بازی می کند
se dlarmon boro mi grdh	سه دلارمون بر می گرده؟
hishki nabayad az in dra vared inja besheh	هیشکی نباید از این درا وارد اینجا بشه
bayan doo nime sria sham khordim man ke asla nfhmidim chi mikhoram	بین دو نیمه سریع شام خوردیم من که اصلا نفهمیدیم چی میخورم
fhimh esfandiar kjast	فهیمه! اسفندیار کجاست ؟
baray sag ha mojoode mi bashad	برای سگ ها موجود می باشد
ke boro paaye oizhgihaii hmchon sen natoani o ghomit ast	که بر پایه ویژگیهایی همچون سن، ناتوانی، و قومیت است
vaght on rasideh ke az aazaar o tbaiz gozaaresh be aanhaayi bbrim ke mitavaanand in nabsamani ra dorost konand	وقت آن رسیده که از آزار و تبعیض گزارش به آنهایی ببریم که میتوانند این نابسامانی را درست کنند
ba cheshmaye koochik o bragh	با چشمای کوچیک و براق
kashef fough alaadh i srzminai davar aftadh	کاشف فوق العاده ی سرزمینای دور افتاده
oaz jadeh be davar aftadh ast	واز جاده به دور افتاده است.
aval dozdi hrfh ie	اول: دزدی حرفه ای
rast gofteh bekhodaa rghasn hmshon pdsga mkhsosn ageh dast o balshonm baz basheh	راست گفته بخدا رقاصن همشون پدسگا. مخصوصن اگه دست و بالشونم باز باشه.
anshaallh drmon koneh dard shmaro	انشاالله درمون کنه درد شمارو
o albate chalshha bghot khod baghi ast	و البته چالشها بقوت خود باقی است
sigar bekeshi mamnoo mikonam	سیگار بکشی ممنوع میکنم
ba iaohgoii oghtm ra tlf konam	با یاوهگویی وقتم را تلف کنم
az asaatid o slatin tghlid sedaye sag	از اساتید و سلاطین تقلید صدای سگ
amma alaave boro an rismaan shanhai niaz peyda kardam	اما علاوه بر ان ریسمان شانهای نیز پیدا کردم.
aanhaa feshar ziadi ehsas mikonand	آنها فشار زیادی احساس میکنند
hlh hooleh anglisi mzkhrf	حله حوله انگلیسی مزخرف
baray iadaori be jahan ke fnaori tanha zamani be nfa jame'e ast ke be ghavaanine asaasi ehteraam begzarad	برای یادآوری به جهان که فنآوری تنها زمانی به نفع جامعه است که به قوانین اساسی احترام بگذارد
dar roozegar ghdimpadshahi sang bozorgi ra dar yek jadeh i asli ghrar dad	در روزگار قدیم،پادشاهی سنگ بزرگی را در یک جاده ی اصلی قرار داد
khoon doid tou saram az asabaniat ro pa band naboodam	خون دوید تو سرم از عصبانیت رو پا بند نبودم
vali in hemaayat hich smri ndashth o airaniha az dashtane mashin arzan o khob bi bahre hastan	ولی این حمایت هیچ ثمری نداشته و ایرانیها از داشتن ماشین ارزان و خوب بی بهره هستن
o nezaakat dashtane tanha be in mana nist ke shoma yek aozi nistid	و نزاکت داشتن تنها به این معنا نیست که شما یک عوضی نیستید
amnh be parvane cheshm mi dozd	امنه به پروانه چشم می دوزد.
un ye tikeh talbi hast	اون یه تیکه طالبی هست
nemidoonam chikar konam	نمیدونم چیکار کنم
ke mitavand ma ra betor balghoh be aanjaa beresand	که میتواند ما را بطور بالقوه به آنجا برساند
ghashang malomh hmhshon ghol gereftan daneshgah ghabool shn dmaghshono amal knn	قشنگ معلومه همهشون قول گرفتن دانشگاه قبول شن دماغشونو عمل کنن!
az zamani ke thdidsh krdno lhsh kardan ta emrouz ke khb darid mi binid	از زمانی که تهدیدش کردنو لهش کردن تا امروز که خب دارید می بینید
shayad daastaanash ra dar chnd jomle kholase konad o man az shrsh khalaas shom	شاید داستانش را در چند جمله خلاصه کند و من از شرش خلاص شوم
baray inke ayande dstiabi be ahdaafe tose'e paydar daroon mrzhai siarhai ra knkash konim	برای اینکه آینده دستیابی به اهداف توسعه پایدار درون مرزهای سیارهای را کنکاش کنیم
shayad begid chera yek saa'at ro nmikhoabm ke bayad begam ya hameh ya hichks	شاید بگید چرا یک ساعت رو نمیخوابم که باید بگم یا همه یا هیچکس
pish be soi majrajoii	پیش به سوی ماجراجویی
kofth i tou ro doost darn	کوفته ی تو رو دوست دارن
ba abjoi mimon derakhshaane	با آبجوی میمون درخشان
az jaayegaahe bala raftam o dar moghaabele mkhatbin ghrar gereftam	از جایگاه بالا رفتم و در مقابل مخاطبین قرار گرفتم
poste ainstagrami jaaleb amirmahdi zholh drbarh rizeshe gheymate dolar	پست اینستاگرامی جالب امیرمهدی ژوله درباره ریزش قیمت دلار
ma motaghaed boudim ke parkhaashgari rouye amalkard o natije nahaei taasir migozaarad	ما معتقد بودیم که پرخاشگری روی عملکرد و نتیجه نهایی تاثیر میگذارد
mikham vali bad az zhrha	میخام ولی بعد از ظهرها
khb chi shod ke bosidish	خب چی شد که بوسیدیش ؟
chi begam oala az khoda ke pnhon nist az shoma che pnhonhdnbal ye dokhtar khobm brash	چی بگم والا از خدا که پنهون نیست از شما چه پنهونه،دنبال یه دختر خوبم براش.
va parvane jan tou nemi shnasi frshad manoo ye khaanom andaaz sho bgirh	وا پروانه جان تو نمی شناسی فرشاد منو؟ یه خانم انداز شو بگیره؟
akhh hia ham vaase admizad khob chizih	اخه حیا هم واسه ادمیزاد خوب چیزیه!
khb pas komak kon darash biarm	خب پس کمک کن درش بیارم
o bad aonaro btkonim	و بعد اونارو بتکونیم ؟
tou gorooh marg aftadim	تو گروه مرگ افتادیم
chizi ke msalh ra skhttr ham mikonad ankh aghlab tanha goah aanche boro ma rfthast khatrat ma hastand	چیزی که مساله را سختتر هم میکند آنکه، اغلب تنها گواه آنچه بر ما رفتهاست، خاطرات ما هستند
hameh sbhha ham nbodsh	.همه صبحها هم نبودش
maadh borhaani be onvan kaapitaane tim meli ke ghbla sabghh bazi dar sooperlige bolghaarestaan ra dasht	مائده برهانی به عنوان کاپیتان تیم ملی که قبلا سابقه بازی در سوپرلیگ بلغارستان را داشت
ba tbsmi goft sbbsh maadaram boud goftam chegouneh	با تبسمی گفت :سببش مادرم بود، گفتم چگونه؟
ahan in vaziat hadih	آهان ، این وضعیت حادیه
ashegh ke bashi ba kmtrin amkanat ham mitoni asheghet sabet kony	عاشق که باشی با کمترین امکانات هم میتونی عشقت ثابت کنی
mi tonam komak konam az ro eyvoonetoon rad beshin	می تونم کمک کنم از رو ایوونتون رد بشین
roikrdi boro asas ahdaafe o mhlthai az pish taiin shodeh	رویکردی بر اساس اهداف و مهلتهای از پیش تعیین شده
hichki ham nist baghalash konam	هیچکی هم نیست بغلش کنم
o dar toul na sal aanhaa be rkord behtarin amalkard dar tamam doran residand	و در طول نه سال آنها به رکورد بهترین عملکرد در تمام دوران رسیدند
chegouneh mitavanim shrktha ra mjab konim be dastresi be kherade jamat miansal	چگونه میتوانیم شرکتها را مجاب کنیم به دسترسی به خرد جماعت میانسال؟
tahvil bgirmaman jan az aolshm nemi khoastm biam	تحویل بگیرمامان جان از اولشم نمی خواستم بیام.
tou ye bkhshndh ie	تو یه بخشنده ای
man hameh jorh hoato daram	من همه جوره هواتو دارم
behtarin kari ke mitavanam bokonam in ast ke namrai bmanm	بهترین کاری که میتوانم بکنم این است که نامرئی بمانم
shayad vaghteshe rasideh ke aamdanhtr drbarho chgongi hamkaari jmai amal konim	شاید وقتش رسیده که عامدانهتر دربارهٔ چگونگی همکاری جمعی عمل کنیم
hooshe dijital nasl hzarh dar moghaabele hooshe hijani nasl aiks o nasl bad az jang davam	هوش دیجیتال نسل هزاره، در مقابل هوش هیجانی نسل ایکس و نسل بعد از جنگ دوم
brtri manoo lams krd	.برتری منو لمس كرد
" mohaghagh goft ""to mshklt chieh tou dir mirsi tou bimsaolit hsti"	" محقق گفت، ""تو مشکلت چیه؟ تو دیر میرسی، تو بیمسئولیت هستی"
ya in taamlat rozanhai ke ou ba karknansh dasht dar raahro dar ghzakhori ya dar jlsat	یا این تعاملات روزانهای که او با کارکنانش داشت، در راهرو، در غذاخوری یا در جلسات
titr zdh kodaam astan khaneh khalihai bishtari darad	تیتر زده کدام استان خانه خالیهای بیشتری دارد؟
chizi vaase tozih nmondh	چیزی واسه توضیح نمونده
vazir ke dar aanjaa boud goft negaran nabashid tamam chizhaii ke rokh midahad dar jahat kheir o slah shomast	وزیر که در آنجا بود گفت : نگران نباشید تمام چیزهایی که رخ میدهد در جهت خیر و صلاح شماست !
befarmaayid ghzaton meyl konid	بفرمایید غذاتون میل کنید
be raist ke oonja oastadh bego	به رئیست که اونجا واستاده بگو
touye grdhmaii ha mibinan	توی گردهمآیی ها میبینن
na shoma beshin man mi ram ke maamaanam nist bgirh janeb mo	نه شما بشین من می رم که مامانم نیست بگیره جانب مو.
tou asemoun monavar mizadan aksai yaadegaari migereftan	، تو آسمون منور میزدن، عکسای یادگاری میگرفتن
are hala ke be shoma reside droghh pas chera mal man rasth han javaab bedin	آره؟ حالا که به شما رسید دروغه؟ پس چرا مال من راسته؟ هان؟ جواب بدین؟
hala hameh mahal bayad ghfl bznn be khshtk shohrashon az tars tou	حالا همه محل باید قفل بزنن به خشتک شوهراشون از ترس تو.
mi toanstim bish az haftaad o shesh plh ham so'ood konim	می توانستیم بیش از هفتاد و شش پله هم صعود کنیم
bdahhkari bayan nasli dar mosighi o hnr shenaakhte shodeh ast	بداههکاری بین نسلی در موسیقی و هنر شناخته شده است
in kheili ghm angiz hast	این خیلی غم انگیز هست
are rghas lkhti dzdidsh	آره ، رقاص لختی دزدیدش
khb tou chikar mi kni	خب ، تو چیكار می كنی؟
ke ma ra boro eijad broniabiha ghadr sakhteh ta shbihsazihaii baray pishbini ayande bsazim	که ما را بر ایجاد برونیابیها قادر ساخته تا شبیهسازیهایی برای پیشبینی آینده بسازیم
o man hala tojhm ra matof kmkrsani bmrdm dar anjam zbt o gozaaresh aazaar o tbaiz dar mahal kar mikonam	و من حالا توجهم را معطوف کمکرسانی بمردم در انجام ضبط و گزارش آزار و تبعیض در محل کار میکنم
khob ejaze bedahid doostam kaaylaa ra moarefi konam	خوب اجازه بدهید دوستم کایلا را معرفی کنم
amma kaaylaa hamchenaan dar froshgahhai srasr jahan baray kharide orze shodeh ast	اما، کایلا همچنان در فروشگاههای سراسر جهان برای خرید عرضه شده است
tou kelaasemoon ye psrahl asfhan boud	تو کلاسمون یه پسراهل اصفهان بود
ba rghas lkhti khoabidi-	با رقاص لختی خوابیدی؟-
o hmsho madyoon sks hastim	و همشو مدیون سکس هستیم
yek tahghigh oaghaa ghavi dar in mavared az morgan make kal o maikl lombrado vojood darad	یک تحقیق واقعا قوی در این مورد از مورگان مک کال و مایکل لومبرادو وجود دارد
aahaay aghaye raeis are ba tou am	آهای، آقای رئیس آره، با تو ام
ye daghigheh pish sohbat kardie	یه دقیقه پیش صحبت کردی
ageh bayaane digeh baraatoon frsti nmimonh az rah posht baam akharin forsat shomast	اگه بیان دیگه براتون فرصتی نمیمونه .. از راه پشت بام، آخرین فرصت شماست.
tou khiaboun dari rah miri har doo nafari ke az kenaret rad mishn darn dar mavared dolar harfe mizanan	تو خیابون داری راه میری هر دو نفری که از کنارت رد میشن دارن در مورد دلار حرف میزنن
ye shohr darim mach kardan ro shmih bandi kardeh	یه شوهر داریم ماچ کردن رو سهمیه بندی کرده
ba khnde in ke hamash shod moush fekr kardam asmt dio se srh	با خنده این که همش شد موش. فکر کردم اسمت دیو سه سره.
dar ghesmat davam in reshte toiit be ou o emperaatoori rsanhai ke tasis karde bishtar khaahim pardakht	در قسمت دوم این رشته توییت، به او و امپراتوری رسانهای که تأسیس کرد، بیشتر خواهیم پرداخت
khodesh baraatoon ain iotob astrim mikone niazi nist sabr knin film danlod sheh	خودش براتون عین یوتوب استریم میکنه نیازی نیست صبر کنین فیلم دانلود شه
dar haghighat siarhai paydar pishniazi baray brkhordari bashar az rfah rouye zamin ast	در حقیقت، سیارهای پایدار پیشنیازی برای برخورداری بشر از رفاه روی زمین است
in be jzabit lig ezafeh mi konad o ma ham baray resiadan be rdh hay balatr tlash mi konim	این به جذابیت لیگ اضافه می کند و ما هم برای رسیدن به رده های بالاتر تلاش می کنیم
daghighan che vaght o drkdam tarikh rouye dad	دقیقاً چه وقت و درکدام تاریخ روی داد؟
an mard ngonbkht mirft	ان مرد نگونبخت میرفت
khnde o khoandn yek mozoo ast fhmidn mozoo digari ast	(خنده) و خواندن یک موضوع است، فهمیدن موضوع دیگری است
o ba in prozh ma hamchenin kari jadid anjam midhim	و با این پروزه ما همچنین کاری جدید انجام میدهیم
hichoght saei nakardam behesh lebas hayeh ba baar mfhomi jnsiti mesle abi bposhanm	هیچوقت سعی نکردم بهش لباسهای با بار مفهومی جنسیتی مثل ابی بپوشانم
hosele anjam karhaie zaroori rahm nadaarid	حوصله انجام کارهای ضروری راهم ندارید؟
sen man doo baraabare dojin mhnds dar on otagh boud	سن من دو برابر دوجین مهندس در آن اتاق بود
aknoon tavanaei ada kardan bdhkarish ra darad vali takhir mi andazd	اکنون توانایی ادا کردن بدهکاریش را دارد ولی تاخیر می اندازد
tou cheghadr saade ie kodoom mard o didi malh nkshn be trkmon	تو چقدر ساده ای؟ کدوم مرد و دیدی ماله نکشن به ترکمون؟
ounam na bekhaatere shoma bekhaatere un ghnari khaanom khng khoushgel behetoon forsat dadam	اونم نه بخاطر شما. بخاطر اون قناری خانم خنگ خوشگل بهتون فرصت دادم.
ki miad az khatrh raftanesh be paark shahr harfe bznh	کی میاد از خاطره رفتنش به پارک شهر حرف بزنه ؟
man un abar mi shnasm	من اون ابر می شناسم
o agar har kodaam az in noghat tamas ra be khoobi modiriat mikard baes mishd karkonan ehsas arzesh konand	و اگر هر کدام از این نقاط تماس را به خوبی مدیریت میکرد، باعث میشد کارکنان احساس ارزش کنند
baray man gheymate dolar mohem nist	برای من قیمت دلار مهم نیست
sevom takhir vaghei paradaim tose'e ast	سوم تغییر واقعی پارادایم توسعه است
mesle raychel tou dbirstanh	!مثل ریچل تو دبیرستانه
"""afsanh mard khtnh nshdh"" "	"""افسانه مرد ختنه نشده"" "
agar ghrar boud be arzesh ha o aghaid ehteraam gozaashte	اگر قرار بود به ارزش ها و عقاید احترام گذاشت
ta goftan jokhai znndh ta payam dadan dar hangam jalaseh	تا گفتن جوکهای زننده تا پیام دادن در هنگام جلسه
hengami ke maadaram fahmide skht mara tanbih karde o mara gheyr msol o bi havaas o	هنگامی که مادرم فهمید سخت مرا تنبیه کرد و مرا غیر مسول و بی حواس و
sinh ye zan ro lams karde	سینه یه زن رو لمس کرد؟
tasmimaat khodavand az ghodrat dark ma kharej ast amma hamishe be sood ma mi bashad	تصمیمات خداوند از قدرت درک ما خارج است اما همیشه به سود ما می باشد
aknoon in shoma ra ghadam bghdm dar dadan etelaa'aati ke mortabet bashad rhnmon mishod	اکنون این شما را قدم بقدم در دادن اطلاعاتی که مرتبط باشد رهنمون میشود
kamla mrbot be negah taraf moghaabele o inke ou ehsas bi ahtrami kardeh bashad bastegi darad	کاملا مربوط به نگاه طرف مقابل و اینکه او احساس بی احترامی کرده باشد بستگی دارد
asmonm ke mididi ye aalmh balon arzoha dasht ke kheili az zamin faseleh gerfte boudan o harekat mikrdn	اسمونم که میدیدی یه عالمه بالن ارزوها داشت که خیلی از زمین فاصله گرفته بودن و حرکت میکردن
moadab boudan vaghei yani karhaie kochki anjam dahim	مودب بودن واقعی یعنی کارهای کوچکی انجام دهیم
ba yeki az ham khaabgahi ham kheili samimi boudim	با یکی از هم خوابگاهی هام خیلی صمیمی بودیم
ma mitavanim in oiros ra hrjaii bbrim -- dar khaneh internet madrese o dar jame'e	ما میتوانیم این ویروس را هرجایی ببریم -- در خانه، اینترنت، مدرسه و در جامعه
raas baavaram nemisheh gofti	راس ، باورم نمیشه گفتی
amnh balakhrh tou in psrh ro didi yana	امنه بالاخره تو این پسره رو دیدی یانه؟
shayad dar jahan khanh-ashtraki aanghadr ahameiat ndashth bashad	شاید در جهان خانه-اشتراکی آنقدر اهمیت نداشته باشد
dar kodaam mogheeat makaani o koja etefagh oftade pas az rokhdad az on ba che kasi harfe zadid	در کدام موقعیت مکانی و کجا اتفاق افتاد؟ پس از رخداد از آن با چه کسی حرف زدید؟
kenar ye mimon bkhoabi	کنار یه میمون بخوابی ؟
goft az doostam medad gereftam be ou goftam khoubeh doostat az tou chizi nkhoast khoraaki chizi	گفت از دوستم مداد گرفتم به او گفتم: خوبه ، دوستت از تو چیزی نخواست؟ خوراکی چیزی
ye shohrdarim vaghti behesh goftam tloizion baraat mhmtrh bghlm krdo goft	یه شوهرداریم وقتی بهش گفتم تلویزیون برات مهمتره بغلم کردو گفت
sـkan hejdah drjh be samt jonoob bchrkhonid	سـکان هجده درجه به سمت جنوب بچرخونید
hala khoubeh maman touye joonish khodesh atish paare ie boudeh ha	حالا خوبه مامان توی جوونیش خودش اتیش پاره ای بوده ها.
sar damaagh biad bacheam htma barrooye cheshmam	سر دماغ بیاد بچم حتما بروی چشمم.
behetoon ghol midam hamin shjaa del ke khoudam basham tosh sot dmbsho begiram o partesh konam biroon	بهتون قول میدم همین شجاع دل که خودم باشم توسه سوت دمبشو بگیرم و پرتش کنم بیرون.
migeh nkbt ouna az haroard ansraf dadan na az payam navar	میگه نکبت اونا از هاروارد انصراف دادن نه از پیام نور
na agha moshkel ast ke adm onja daakhel shood digar asb jaaye khod ra darad	نه اقا، مشکل است که ادم انجا داخل شود دیگر اسب جای خود را دارد
ras az didanet khoshbakhtam	رآس ، از دیدنت خوشبختم
hmino mi khoastin shod idfah davar ham jma shim paye in mrda ro tou mjlsmon va nknin	همینو می خواستین؟ شد یدفعه دور هم جمع شیم پای این مردا رو تو مجلسمون وا نکنین
are fekr konam alaan delam	آره ، فکر کنم الان دلم
dorost mesle oobre eshteraaki	درست مثل اوبر اشتراکی
imaan majrajo hmknon vared mi shood	ایمان ماجراجو همکنون وارد می شود
azlat e bdnt ro shl kon	عضلات ِ بدنت رو شل کن
shoma chera nshsti inja hey tar tar mi khndi	شما چرا نشستی اینجا هی تر تر می خندی؟
khob iadgarihdkhtrh khoasth film jhazi ke babash koli hazine kardeh o behesh dadeh ro ngh dareh	خوب یادگاریه،دختره خواسته فیلم جهازی که باباش کلی هزینه کرده و بهش داده رو نگه داره
maman shoma khodet didi agha milad ro ke hameh ro jma kardie inja	مامان شما خودت دیدی اقا میلاد رو که همه رو جمع کردی اینجا؟
az taraf saidh hshrh eshgh	!از طرف سعیده. حشره عشق
man booye aaloo khoshk o znjbil mi shnom	من بوی آلو خشک و زنجبیل می شنوم
be hrhal kasaayi ke tou in veblaag hastan o dastan ha ro mikhoonan ghatan eshgh o tajrobe kardan	به هرحال کسایی که تو این وبلاگ هستن و داستان ها رو میخونن قطعا عشق و تجربه کردن
fardaa sobh az khaneh i mehr baznshstgan mian dnbalton	فردا صبح از خانه ی مهر بازنشستگان میان دنبالتون
azadh asla bro touye hmon otagh behesh bedeh	ازاده اصلا برو توی همون اتاق بهش بده.
hanouz chnd satri nnoshth bodam ke yeki az rofaghaaye zendan jlom sabz shod kenar takht neshast	هنوز چند سطری ننوشته بودم که، یکی از رفقای زندان جلوم سبز شد، کنار تخت نشست
o sadghanh begouim in ghzih man ra kheili ziad mitrsand	و صادقانه بگویم این قضیه من را خیلی زیاد میترساند
hamin alaan az oobre eshteraaki piadh shodam	همین الان از اوبر اشتراکی پیاده شدم
shayad khiliatonm shkstsho tajrobe krdin oaomdin inja ke ye joraii aroom beshin	شاید خیلیاتونم شکستشو تجربه کردین واومدین اینجا که یه جورایی اروم بشین
matghdh mach tou rouz faghat yek barbishtr az yek baar los bazih	معتقده ماچ تو روز فقط یک بار،بیشتر از یک بار لوس بازیه
anghd zibaast ke aadam doost dareh oonja baajenaaghe sho bkshh bad rahaa koneh brh	انقد زیباست که آدم دوست داره اونجا باجناق شو بکشه بعد رها کنه بره
shioh amal aanhaa salb kardan ast ya hedaayat poul be srmaihhai motamarkez dar atefi ast	شیوه عمل آنها سلب کردن است یا هدایت پول به سرمایههای متمرکز در عاطفی است
baazam mi kobmt be zamin	بازم می کوبمت به زمین
hanouz chnd satri nnoshth bodam khiki az rofaghaaye zendan jlom sabz shdknar takht neshast	هنوز چند سطری ننوشته بودم که،یکی از رفقای زندان جلوم سبز شد،کنار تخت نشست
nhzod zoud un parandeh doubareh mal ma misheh	نه،زود زود اون پرنده دوباره مال ما میشه
harchi ke hast saih bala srmh behtaere az toah ke shohr tou frari dadi ba douta bache tou damnt	هرچی که هست سایه بالا سرمه بهتر از توئه که شوهر تو فراری دادی با دوتا بچه تو دامنت
in proseh mesle yek oiros amal mikard	این پروسه مثل یک ویروس عمل میکرد
dashtam dar atash tbaiz jnsiti misokhtm	داشتم در آتش تبعیض جنسیتی میسوختم
chera bayad chiz bdi basheh	چرا باید چیز بدی باشه؟
yad gereftan az besiari az kshorhai dar hal tose'e ke kheili sria harekat krdhand	یاد گرفتن از بسیاری از کشورهای در حال توسعه که خیلی سریع حرکت کردهاند
kar nakardeh kheili daram chjori brsm be in kaaraa	کار نکرده خیلی دارم چجوری برسم به این کارا؟
vaghti migan bro mohandesi bkhon hnrm knarsh edameh midi	وقتی میگن برو مهندسی بخون هنرم کنارش ادامه میدی
fibz bshghabt ro bardar	فیبز ، بشقابت رو بردار
mi donm che kar mi karde	.می دونم چه کار می کرد
khdabh ou goft man didam ke ghom tou be ham rhm krdndmn chegouneh be in ghom rhm nknm	خدابه او گفت من دیدم که قوم تو به هم رحم کردندمن چگونه به این قوم رحم نکنم؟
in akhalghat bedeh ha ageh bkhad khodesh taarf mi koneh fekr konam khoshash niomd	این اخالقات بده ها. اگه بخاد خودش تعارف می کنه. فکر کنم خوشش نیومد.
zibaayaan nemitavaanand khod ra bposhanndzibaii navar ast o penhan nemimaanad	زیبایان نمیتوانند خود را بپوشانند.زیبایی نور است و پنهان نمیماند
khobhala be eftekhar tamam kashfai koochooloo	خوب،حالا به افتخار تمام کاشفای کوچولو
aya motmaen hastid ke aanhaa be nazar kheili toulani nistand	آیا مطمئن هستید که آنها به نظر خیلی طولانی نیستند
didam hmon pessar hastesh ye lahze tamam bdnm yakh shod	دیدم همون پسر هستش یه لحظه تمام بدنم یخ شد
sbha mi kshim ta laaghl hioona srhal bashn	صبحا می کشیم تا لااقل حیوونا سرحال باشن.
amma aya vaghean shoroot ra molaheze krdhaid	اما آیا واقعاً شروط را ملاحظه کردهاید؟
doo del baray raftan dast be shekamash mi znd fekr konam besheh falaa tahamolesh karde	دو دل برای رفتن، دست به شکمش می زند فکر کنم بشه فعلاً تحملش کرد.
setaare klassh shod btorikh hameh ou ra saheb mdadhai zkhirh mi shnakhtnd o hamishe az ou komak mi gereftand	ستاره کلاسش شد بطوریکه همه او را صاحب مدادهای ذخیره می شناختند و همیشه از او کمک می گرفتند
kaaylaa ghablit etesal be shbkh jahani o daaraaye tknolozhi tashkhise seda boud	کایلا قابلیت اتصال به شبکه جهانی و دارای تکنولوژی تشخیص صدا بود
doost dokhtaram be shookhi goft midouni asabaniat man baes shkstn astkhonat misheh	دوست دخترم به شوخی گفت میدونی عصبانیت من باعث شکستن استخونات میشه؟
man donbal ye ketab hastam	من دنبال یه کتاب هستم
ghodrat be shekl bisabghhai bsoi joanha sarazir mishod be dalil afzaayesh oabstgi ma be diQ hooshe dijital	قدرت، به شکل بیسابقهای بسوی جوانها سرازیر میشود به دلیل افزایش وابستگی ما به DQ : هوش دیجیتال
khoda azashoun ngzrh poost mondh o astkhon azshab shodeh bacheam	خدا ازشون نگذره پوست مونده و استخون ازش.اب شده بچم
o aanhaa ra toanmnd sakht ta daaraaye seda shavand	و آنها را توانمند ساخت تا دارای صدا شوند
parli kar jmaaori zaiaat plastiki az aghianos ra darad	پارلی کار جمعآوری ضایعات پلاستیکی از اقیانوس را دارد
riis pishin FBI dar otomobil khod minshst	رییس پیشین FBI در اتومبیل خود مینشست
ghalam ra rouye kaaghaz gzashtmmikhoastm be ou befahmaanam ke kar fori o foti daram	قلم را روی کاغذ گذاشتم،میخواستم به او بفهمانم که کار فوری و فوتی دارم
hamash ghabl az saa'at dah boud	همش قبل از ساعت ده بود
man joei hastam bazigrm	!من جویی هستم! بازیگرم
in rbat boston dainamiks har sari dareh trsnaktr misheh	این ربات بوستون داینامیکس هر سری داره ترسناکتر میشه
az hameh mohemtar movafagh be kashf raaz o moamaaye ghadimi khod shodam	از همه مهمتر موفق به کشف راز و معمای قدیمی خود شدم
chnd baar begam dozdi dar kar nist eshaare be mstrah moshkel az oonjast	چند بار بگم دزدی در کار نیست اشاره به مستراح مشکل از اونجاست.
salam raychel , khuneh ie	سلام ریچل , خونه ای ؟
gـlai azalia mo mi khorh	گـلای آزالیا مو می خوره
chndler kheili ba mohebate boud	چندلر خیلی با محبت بود
khrmgsi khod ra be an zkhm chsbanidh boud ke motavajeh amdn man nashod	خرمگسی خود را به ان زخم چسبانیده بود که متوجه امدن من نشد
aya behtaere nist sht asnad o ghablit hk zendeh kaaylaa ra ba ham brrsi konim ou injast	آیا بهتر نیست صحت اسناد و قابلیت هک زنده کایلا را با هم بررسی کنیم؟ او اینجاست
hengami ke shrktha hmpimani ra be afradshan amouzesh midahand brnamhhai jama o mtnoa ghoitr mishavand	هنگامی که شرکتها، همپیمانی را به افرادشان آموزش میدهند، برنامههای جامع و متنوع، قویتر میشوند
khob vaase moze ha bmon	.خوب واسه موزه ها بمون
ta bfhmim che klah bzrgi in jmhori aslami sar ma gozashteh o migzarh o vaghean dzdh	تا بفهمیم چه كلاه بزرگى این جمهورى اسلامى سر ما گذاشته و میگذاره و واقعاً دزده
bish az zaman film maratn yeki az filmhai hri patr ast o balaoh film pdrkhoandh	بیش از زمان فیلم ماراتن یکی از فیلمهای هری پاتر است و بعلاوه فیلم پدرخوانده
fekr mi kardam tou chndlri	.فکر می کردم تو چندلری
ke mitavand az tavanaei sisteme zamin baray mhiasazi rfah ejtemaai o eghtesaadi davar konad	که میتواند از توانایی سیستم زمین برای مهیاسازی رفاه اجتماعی و اقتصادی دور کند
dar msahbhai ba iori klochin yeki digar az jasosan kagab	در مصاحبهای با یوری کلوچین، یکی دیگر از جاسوسان کاگب
kholase on sal barayam tamrin amali dozdi hrfh ie boud	خلاصه آن سال برایم تمرین عملی دزدی حرفه ای بود
albrai un se ta mantosh ta kif o kafsh o rosri joda begiram	ال:برای اون سه تا مانتو،سه تا کیف و کفش و روسری جدا بگیرم
amra jan o beri ra bebinid ke dar cafe holz food ghahve bezanand	عمرا جان و بری را ببینید که در کافه هولز فود قهوه بزنند
aknoon tavanaei ada kardan bdhkarish ra darad vali takhir mi andazd	اکنون توانایی ادا کردن بدهکاریش را دارد ولی تاخیر می اندازد
o ageh ma in mashinaro nkhrim ki mikhad biad azashoun mashin bkhrh labod #bradr_zn_sdam	و اگه ما این ماشینارو نخریم كی میخواد بیاد ازشون ماشین بخره؟؟ لابد #برادر_زن_صدام
darand barnameh STEM ra thsil miknndalom tknolozhi mohandesi o riazi	دارند برنامه STEM را تحصیل میکنند:علوم، تکنولوژی، مهندسی و ریاضی
vaghti bazito mizarn tou fifa di vali bazham kambk mizni o mi beri	وقتی بازیتو میزارن تو فیفا دی ولی بازهم کامبک میزنی و می بری
ejaze bedahid be shoma neshan daham	اجازه بدهید به شما نشان دهم
vey afzood ba in vojood ghatar hamaanand saayer kshorhai gheyr ozv opek be ta'ahodaat in sazman paayband khahad maand	وی افزود: با این وجود قطر همانند سایر کشورهای غیر عضو اوپک به تعهدات این سازمان پایبند خواهد ماند
na ras tou jaei namiri	نه رآس ، تو جایی نمیری
khrmgsi khod ra be an zkhm chsbanidh boud ke motavajeh amdn man nashod	خرمگسی خود را به ان زخم چسبانیده بود که متوجه امدن من نشد.
yek maghaleh chapshdh dar shori edeaa mikonad oirosi ke baes aidz mishod	یک مقاله چاپشده در شوری ادعا میکند ویروسی که باعث ایدز میشود
chapgr ba ghodrat zom ta char baraabare	چاپگر، با قدرت زوم تا چعر برابر
be sarkaar raas negah konid	به سرکار راس نگاه کنید
tavanaei aanhaa dar estefadeh az kherade biantha o emaal kardanesh boro moshkelaat emroozi	توانایی آنها در استفاده از خرد بیانتها و اعمال کردنش بر مشکلات امروزی
az ghfshha toust sherkat amazon o oal-mart hzf shod	از قفسهها توسط شرکت آمازون و وال-مارت حذف شد
tloizion saa'at khrt o prtaton ba khodetoon bbrin	تلویزیون ساعت خرت و پرتاتون با خودتون ببرین
o blh in kar mstlzm astandardsazi dar nahve andazhgiri atefi az soi ma ast ke mashghoole on hastim	و بله، این کار مستلزم استانداردسازی در نحوه اندازهگیری عاطفی از سوی ما است، که مشغول آن هستیم
chndler tou bro posht miz	چندلر ، تو برو پشت میز
oh un ba nmkh fibz	اوه ، اون با نمکه فیبز
o kaaylaa dar hal hazer dar moze jasosi brlin ba aramesh dar hal astraht ast	و کایلا در حال حاضر در موزه جاسوسی برلین با آرامش در حال استراحت است
majra ro brash tarif kardam un gftmrim ageh midouni pessar khobih khb che ashkali dareh baahaash bishtar ashna bsho	ماجرا رو براش تعریف کردم اون گفت:مریم اگه میدونی پسر خوبیه خب چه اشکالی داره باهاش بیشتر اشنا بشو
man zire eyvoonetoon ghaayem shodam choun doosetoon daarami	من زیر ایوونتون قایم شدم چون دوستون دارمی
o chndler dareh miad khuneh	و چندلر داره میاد خونه
fibi joei ro doost dareh	فیبی جویی رو دوست داره
dar toul panj sal doog hameh chiz ra avaz karde	در طول پنج سال دوگ همه چیز را عوض کرد
khob in amr monjar be che shod kaaylaa dar keshvar aalmaan mamnoo shod	خوب این امر منجر به چه شد؟ کایلا در کشور آلمان ممنوع شد
